bacteria;replicon;gene;start;end;length
ESCO.0722.00035;ESCO.0722.00035.0008;ESCO.0722.00035.0008i_01441;34814;35452;638
ESCO.0722.00035;ESCO.0722.00035.0009;ESCO.0722.00035.0009i_01473;24276;24407;131
ESCO.0722.00035;ESCO.0722.00035.0015;ESCO.0722.00035.0015i_02337;5126;5329;203
ESCO.0722.00035;ESCO.0722.00035.0015;ESCO.0722.00035.0015i_02369;30836;31141;305
ESCO.0722.00035;ESCO.0722.00035.0028;ESCO.0722.00035.0028i_04481;7290;8369;1079
ESCO.0722.00035;ESCO.0722.00035.0029;ESCO.0722.00035.0029i_04513;15734;16057;323
ESCO.0722.00035;ESCO.0722.00035.0070;ESCO.0722.00035.0070b_04769;2;238;236
ESCO.0722.00035;ESCO.0722.00035.0008;ESCO.0722.00035.0008i_01444;36271;38418;2147
ESCO.0722.00035;ESCO.0722.00035.0009;ESCO.0722.00035.0009i_01476;26983;27282;299
ESCO.0722.00035;ESCO.0722.00035.0015;ESCO.0722.00035.0015i_02340;7036;7638;602
ESCO.0722.00035;ESCO.0722.00035.0015;ESCO.0722.00035.0015i_02372;33801;34238;437
ESCO.0722.00035;ESCO.0722.00035.0028;ESCO.0722.00035.0028i_04484;9669;10475;806
ESCO.0722.00035;ESCO.0722.00035.0074;ESCO.0722.00035.0074b_04772;3;89;86
ESCO.0722.00035;ESCO.0722.00035.0008;ESCO.0722.00035.0008i_01427;20556;21908;1352
ESCO.0722.00035;ESCO.0722.00035.0009;ESCO.0722.00035.0009i_01459;3168;4163;995
ESCO.0722.00035;ESCO.0722.00035.0009;ESCO.0722.00035.0009i_01491;37142;38011;869
ESCO.0722.00035;ESCO.0722.00035.0009;ESCO.0722.00035.0009i_01619;170203;170835;632
ESCO.0722.00035;ESCO.0722.00035.0014;ESCO.0722.00035.0014i_02323;70664;70987;323
ESCO.0722.00035;ESCO.0722.00035.0015;ESCO.0722.00035.0015i_02355;17516;19027;1511
ESCO.0722.00035;ESCO.0722.00035.0015;ESCO.0722.00035.0015i_02387;50509;51036;527
ESCO.0722.00035;ESCO.0722.00035.0018;ESCO.0722.00035.0018i_03027;117489;117767;278
ESCO.0722.00035;ESCO.0722.00035.0055;ESCO.0722.00035.0055b_04755;3;425;422
ESCO.0722.00035;ESCO.0722.00035.0088;ESCO.0722.00035.0088b_04787;75;215;140
ESCO.0722.00035;ESCO.0722.00035.0008;ESCO.0722.00035.0008i_01428;21923;23572;1649
ESCO.0722.00035;ESCO.0722.00035.0009;ESCO.0722.00035.0009i_01460;4181;5623;1442
ESCO.0722.00035;ESCO.0722.00035.0009;ESCO.0722.00035.0009i_01492;38156;38491;335
ESCO.0722.00035;ESCO.0722.00035.0014;ESCO.0722.00035.0014i_02324;71630;72025;395
ESCO.0722.00035;ESCO.0722.00035.0015;ESCO.0722.00035.0015i_02356;19039;19482;443
ESCO.0722.00035;ESCO.0722.00035.0015;ESCO.0722.00035.0015i_02388;51052;58605;7553
ESCO.0722.00035;ESCO.0722.00035.0018;ESCO.0722.00035.0018i_03028;117802;118068;266
ESCO.0722.00035;ESCO.0722.00035.0090;ESCO.0722.00035.0090b_04788;1;108;107
ESCO.0722.00035;ESCO.0722.00035.0161;ESCO.0722.00035.0161b_04820;1;66;65
ESCO.0722.00035;ESCO.0722.00035.0008;ESCO.0722.00035.0008i_01429;23550;24170;620
ESCO.0722.00035;ESCO.0722.00035.0009;ESCO.0722.00035.0009i_01461;5624;5962;338
ESCO.0722.00035;ESCO.0722.00035.0009;ESCO.0722.00035.0009i_01493;38668;40356;1688
ESCO.0722.00035;ESCO.0722.00035.0011;ESCO.0722.00035.0011i_02165;340104;340289;185
ESCO.0722.00035;ESCO.0722.00035.0014;ESCO.0722.00035.0014i_02325;72222;73589;1367
ESCO.0722.00035;ESCO.0722.00035.0015;ESCO.0722.00035.0015i_02389;58621;59961;1340
ESCO.0722.00035;ESCO.0722.00035.0018;ESCO.0722.00035.0018i_03029;118023;118775;752
ESCO.0722.00035;ESCO.0722.00035.0021;ESCO.0722.00035.0021b_03733;198161;198559;398
ESCO.0722.00035;ESCO.0722.00035.0057;ESCO.0722.00035.0057b_04757;3;404;401
ESCO.0722.00035;ESCO.0722.00035.0090;ESCO.0722.00035.0090b_04789;109;213;104
ESCO.0722.00035;ESCO.0722.00035.0008;ESCO.0722.00035.0008i_01448;40612;40851;239
ESCO.0722.00035;ESCO.0722.00035.0009;ESCO.0722.00035.0009i_01480;28759;28989;230
ESCO.0722.00035;ESCO.0722.00035.0015;ESCO.0722.00035.0015i_02344;9751;10269;518
ESCO.0722.00035;ESCO.0722.00035.0015;ESCO.0722.00035.0015i_02376;35873;36502;629
ESCO.0722.00035;ESCO.0722.00035.0028;ESCO.0722.00035.0028i_04488;14477;14896;419
ESCO.0722.00035;ESCO.0722.00035.0029;ESCO.0722.00035.0029i_04520;19224;19475;251
ESCO.0722.00035;ESCO.0722.00035.0077;ESCO.0722.00035.0077b_04776;3;122;119
ESCO.0722.00035;ESCO.0722.00035.0008;ESCO.0722.00035.0008i_01417;12244;12444;200
ESCO.0722.00035;ESCO.0722.00035.0008;ESCO.0722.00035.0008i_01449;40893;41261;368
ESCO.0722.00035;ESCO.0722.00035.0009;ESCO.0722.00035.0009i_01481;29020;29112;92
ESCO.0722.00035;ESCO.0722.00035.0015;ESCO.0722.00035.0015i_02345;10266;10550;284
ESCO.0722.00035;ESCO.0722.00035.0015;ESCO.0722.00035.0015i_02377;36625;37008;383
ESCO.0722.00035;ESCO.0722.00035.0017;ESCO.0722.00035.0017i_02889;254471;254758;287
ESCO.0722.00035;ESCO.0722.00035.0035;ESCO.0722.00035.0035i_04713;6810;7235;425
ESCO.0722.00035;ESCO.0722.00035.0077;ESCO.0722.00035.0077b_04777;129;224;95
ESCO.0722.00035;ESCO.0722.00035.0008;ESCO.0722.00035.0008i_01450;41274;41690;416
ESCO.0722.00035;ESCO.0722.00035.0009;ESCO.0722.00035.0009i_01482;31178;32086;908
ESCO.0722.00035;ESCO.0722.00035.0015;ESCO.0722.00035.0015i_02346;10547;11335;788
ESCO.0722.00035;ESCO.0722.00035.0015;ESCO.0722.00035.0015i_02378;37139;38086;947
ESCO.0722.00035;ESCO.0722.00035.0017;ESCO.0722.00035.0017i_02890;254763;255164;401
ESCO.0722.00035;ESCO.0722.00035.0028;ESCO.0722.00035.0028b_04490;15286;16155;869
ESCO.0722.00035;ESCO.0722.00035.0029;ESCO.0722.00035.0029i_04522;20047;20574;527
ESCO.0722.00035;ESCO.0722.00035.0035;ESCO.0722.00035.0035i_04714;7229;7351;122
ESCO.0722.00035;ESCO.0722.00035.0078;ESCO.0722.00035.0078b_04778;3;221;218
ESCO.0722.00035;ESCO.0722.00035.0008;ESCO.0722.00035.0008i_01436;31085;31552;467
ESCO.0722.00035;ESCO.0722.00035.0009;ESCO.0722.00035.0009i_01468;22291;22824;533
ESCO.0722.00035;ESCO.0722.00035.0014;ESCO.0722.00035.0014b_02332;77801;79024;1223
ESCO.0722.00035;ESCO.0722.00035.0015;ESCO.0722.00035.0015i_02364;27566;27937;371
ESCO.0722.00035;ESCO.0722.00035.0015;ESCO.0722.00035.0015i_02396;68835;70352;1517
ESCO.0722.00035;ESCO.0722.00035.0028;ESCO.0722.00035.0028i_04476;2646;2822;176
ESCO.0722.00035;ESCO.0722.00035.0103;ESCO.0722.00035.0103b_04796;1;144;143
ESCO.0722.00035;ESCO.0722.00035.0008;ESCO.0722.00035.0008i_01437;31573;32508;935
ESCO.0722.00035;ESCO.0722.00035.0009;ESCO.0722.00035.0009i_01469;22855;23124;269
ESCO.0722.00035;ESCO.0722.00035.0015;ESCO.0722.00035.0015b_02333;361;1107;746
ESCO.0722.00035;ESCO.0722.00035.0015;ESCO.0722.00035.0015i_02365;27944;29482;1538
ESCO.0722.00035;ESCO.0722.00035.0015;ESCO.0722.00035.0015i_02397;70345;72000;1655
ESCO.0722.00035;ESCO.0722.00035.0028;ESCO.0722.00035.0028i_04477;2825;3445;620
ESCO.0722.00035;ESCO.0722.00035.0064;ESCO.0722.00035.0064b_04765;3;290;287
ESCO.0722.00035;ESCO.0722.00035.0003;ESCO.0722.00035.0003i_00866;888774;889040;266
ESCO.0722.00035;ESCO.0722.00035.0008;ESCO.0722.00035.0008i_01442;35442;35996;554
ESCO.0722.00035;ESCO.0722.00035.0009;ESCO.0722.00035.0009i_01474;24410;24907;497
ESCO.0722.00035;ESCO.0722.00035.0015;ESCO.0722.00035.0015i_02338;5345;5881;536
ESCO.0722.00035;ESCO.0722.00035.0015;ESCO.0722.00035.0015i_02370;32113;33015;902
ESCO.0722.00035;ESCO.0722.00035.0020;ESCO.0722.00035.0020i_03490;155437;155964;527
ESCO.0722.00035;ESCO.0722.00035.0028;ESCO.0722.00035.0028i_04482;8366;8545;179
ESCO.0722.00035;ESCO.0722.00035.0029;ESCO.0722.00035.0029i_04514;16101;16346;245
ESCO.0722.00035;ESCO.0722.00035.0071;ESCO.0722.00035.0071b_04770;3;86;83
ESCO.0722.00035;ESCO.0722.00035.0005;ESCO.0722.00035.0005i_00953;13758;14297;539
ESCO.0722.00035;ESCO.0722.00035.0006;ESCO.0722.00035.0006i_00985;9413;10375;962
ESCO.0722.00035;ESCO.0722.00035.0006;ESCO.0722.00035.0006i_01017;36652;39372;2720
ESCO.0722.00035;ESCO.0722.00035.0008;ESCO.0722.00035.0008i_01433;26810;27523;713
ESCO.0722.00035;ESCO.0722.00035.0009;ESCO.0722.00035.0009i_01465;10007;11752;1745
ESCO.0722.00035;ESCO.0722.00035.0014;ESCO.0722.00035.0014i_02265;8661;9833;1172
ESCO.0722.00035;ESCO.0722.00035.0014;ESCO.0722.00035.0014i_02329;76591;76839;248
ESCO.0722.00035;ESCO.0722.00035.0015;ESCO.0722.00035.0015i_02361;24748;25143;395
ESCO.0722.00035;ESCO.0722.00035.0015;ESCO.0722.00035.0015i_02393;64382;64879;497
ESCO.0722.00035;ESCO.0722.00035.0028;ESCO.0722.00035.0028i_04473;576;1805;1229
ESCO.0722.00035;ESCO.0722.00035.0029;ESCO.0722.00035.0029b_04537;28459;28806;347
ESCO.0722.00035;ESCO.0722.00035.0061;ESCO.0722.00035.0061b_04761;3;296;293
ESCO.0722.00035;ESCO.0722.00035.0094;ESCO.0722.00035.0094b_04793;2;178;176
ESCO.0722.00035;ESCO.0722.00035.0005;ESCO.0722.00035.0005i_00954;14290;15111;821
ESCO.0722.00035;ESCO.0722.00035.0006;ESCO.0722.00035.0006i_00986;10413;11957;1544
ESCO.0722.00035;ESCO.0722.00035.0006;ESCO.0722.00035.0006i_01018;39523;40221;698
ESCO.0722.00035;ESCO.0722.00035.0008;ESCO.0722.00035.0008i_01434;27582;28109;527
ESCO.0722.00035;ESCO.0722.00035.0009;ESCO.0722.00035.0009i_01466;11838;21653;9815
ESCO.0722.00035;ESCO.0722.00035.0014;ESCO.0722.00035.0014i_02266;9963;10127;164
ESCO.0722.00035;ESCO.0722.00035.0014;ESCO.0722.00035.0014i_02330;76913;77188;275
ESCO.0722.00035;ESCO.0722.00035.0015;ESCO.0722.00035.0015i_02362;25140;26114;974
ESCO.0722.00035;ESCO.0722.00035.0015;ESCO.0722.00035.0015i_02394;64886;65278;392
ESCO.0722.00035;ESCO.0722.00035.0028;ESCO.0722.00035.0028i_04474;1882;2148;266
ESCO.0722.00035;ESCO.0722.00035.0095;ESCO.0722.00035.0095b_04794;148;210;62
ESCO.0722.00035;ESCO.0722.00035.0008;ESCO.0722.00035.0008i_01435;28190;30244;2054
ESCO.0722.00035;ESCO.0722.00035.0009;ESCO.0722.00035.0009i_01467;21650;22093;443
ESCO.0722.00035;ESCO.0722.00035.0014;ESCO.0722.00035.0014i_02331;77269;77697;428
ESCO.0722.00035;ESCO.0722.00035.0015;ESCO.0722.00035.0015i_02363;26128;27576;1448
ESCO.0722.00035;ESCO.0722.00035.0015;ESCO.0722.00035.0015i_02395;65458;68709;3251
ESCO.0722.00035;ESCO.0722.00035.0028;ESCO.0722.00035.0028i_04475;2153;2386;233
ESCO.0722.00035;ESCO.0722.00035.0096;ESCO.0722.00035.0096b_04795;1;204;203
ESCO.0722.00035;ESCO.0722.00035.0008;ESCO.0722.00035.0008i_01443;35996;36193;197
ESCO.0722.00035;ESCO.0722.00035.0009;ESCO.0722.00035.0009i_01475;25075;25998;923
ESCO.0722.00035;ESCO.0722.00035.0015;ESCO.0722.00035.0015i_02339;5930;6850;920
ESCO.0722.00035;ESCO.0722.00035.0015;ESCO.0722.00035.0015i_02371;33048;33371;323
ESCO.0722.00035;ESCO.0722.00035.0020;ESCO.0722.00035.0020i_03491;156162;156296;134
ESCO.0722.00035;ESCO.0722.00035.0028;ESCO.0722.00035.0028i_04483;8884;9570;686
ESCO.0722.00035;ESCO.0722.00035.0029;ESCO.0722.00035.0029i_04515;16336;16551;215
ESCO.0722.00035;ESCO.0722.00035.0008;ESCO.0722.00035.0008i_01421;14625;14882;257
ESCO.0722.00035;ESCO.0722.00035.0008;ESCO.0722.00035.0008i_01453;43226;44722;1496
ESCO.0722.00035;ESCO.0722.00035.0009;ESCO.0722.00035.0009i_01485;33504;33941;437
ESCO.0722.00035;ESCO.0722.00035.0009;ESCO.0722.00035.0009i_01613;163445;164101;656
ESCO.0722.00035;ESCO.0722.00035.0015;ESCO.0722.00035.0015i_02349;14512;14856;344
ESCO.0722.00035;ESCO.0722.00035.0015;ESCO.0722.00035.0015i_02381;40089;42269;2180
ESCO.0722.00035;ESCO.0722.00035.0029;ESCO.0722.00035.0029i_04493;951;1202;251
ESCO.0722.00035;ESCO.0722.00035.0029;ESCO.0722.00035.0029i_04525;22533;22622;89
ESCO.0722.00035;ESCO.0722.00035.0036;ESCO.0722.00035.0036b_04717;160;780;620
ESCO.0722.00035;ESCO.0722.00035.0082;ESCO.0722.00035.0082b_04781;1;180;179
ESCO.0722.00035;ESCO.0722.00035.0146;ESCO.0722.00035.0146b_04813;1;75;74
ESCO.0722.00035;ESCO.0722.00035.0008;ESCO.0722.00035.0008i_01422;15948;16784;836
ESCO.0722.00035;ESCO.0722.00035.0008;ESCO.0722.00035.0008i_01454;44719;45204;485
ESCO.0722.00035;ESCO.0722.00035.0009;ESCO.0722.00035.0009i_01486;34035;34391;356
ESCO.0722.00035;ESCO.0722.00035.0015;ESCO.0722.00035.0015i_02350;14856;15098;242
ESCO.0722.00035;ESCO.0722.00035.0015;ESCO.0722.00035.0015i_02382;42735;42941;206
ESCO.0722.00035;ESCO.0722.00035.0029;ESCO.0722.00035.0029i_04526;23553;23804;251
ESCO.0722.00035;ESCO.0722.00035.0050;ESCO.0722.00035.0050b_04750;3;269;266
ESCO.0722.00035;ESCO.0722.00035.0083;ESCO.0722.00035.0083b_04782;3;161;158
ESCO.0722.00035;ESCO.0722.00035.0149;ESCO.0722.00035.0149b_04814;1;75;74
ESCO.0722.00035;ESCO.0722.00035.0008;ESCO.0722.00035.0008i_01423;16884;17123;239
ESCO.0722.00035;ESCO.0722.00035.0008;ESCO.0722.00035.0008i_01455;45201;45635;434
ESCO.0722.00035;ESCO.0722.00035.0009;ESCO.0722.00035.0009i_01487;34502;35014;512
ESCO.0722.00035;ESCO.0722.00035.0011;ESCO.0722.00035.0011i_01967;116067;117959;1892
ESCO.0722.00035;ESCO.0722.00035.0015;ESCO.0722.00035.0015i_02351;15142;15540;398
ESCO.0722.00035;ESCO.0722.00035.0015;ESCO.0722.00035.0015i_02383;43237;43683;446
ESCO.0722.00035;ESCO.0722.00035.0020;ESCO.0722.00035.0020i_03439;90108;91010;902
ESCO.0722.00035;ESCO.0722.00035.0029;ESCO.0722.00035.0029i_04495;1705;2217;512
ESCO.0722.00035;ESCO.0722.00035.0029;ESCO.0722.00035.0029i_04527;23794;24075;281
ESCO.0722.00035;ESCO.0722.00035.0036;ESCO.0722.00035.0036i_04719;4924;5247;323
ESCO.0722.00035;ESCO.0722.00035.0084;ESCO.0722.00035.0084b_04783;1;102;101
ESCO.0722.00035;ESCO.0722.00035.0008;ESCO.0722.00035.0008i_01419;13339;13518;179
ESCO.0722.00035;ESCO.0722.00035.0008;ESCO.0722.00035.0008i_01451;41683;42327;644
ESCO.0722.00035;ESCO.0722.00035.0009;ESCO.0722.00035.0009i_01483;32094;32705;611
ESCO.0722.00035;ESCO.0722.00035.0015;ESCO.0722.00035.0015i_02379;38207;38893;686
ESCO.0722.00035;ESCO.0722.00035.0029;ESCO.0722.00035.0029b_04491;3;599;596
ESCO.0722.00035;ESCO.0722.00035.0029;ESCO.0722.00035.0029i_04523;20710;21114;404
ESCO.0722.00035;ESCO.0722.00035.0080;ESCO.0722.00035.0080b_04779;68;220;152
ESCO.0722.00035;ESCO.0722.00035.0008;ESCO.0722.00035.0008i_01420;14020;14577;557
ESCO.0722.00035;ESCO.0722.00035.0008;ESCO.0722.00035.0008i_01452;42324;43229;905
ESCO.0722.00035;ESCO.0722.00035.0009;ESCO.0722.00035.0009i_01484;33057;33419;362
ESCO.0722.00035;ESCO.0722.00035.0009;ESCO.0722.00035.0009i_01612;162881;163393;512
ESCO.0722.00035;ESCO.0722.00035.0015;ESCO.0722.00035.0015i_02348;13421;14173;752
ESCO.0722.00035;ESCO.0722.00035.0015;ESCO.0722.00035.0015i_02380;39609;39932;323
ESCO.0722.00035;ESCO.0722.00035.0029;ESCO.0722.00035.0029i_04492;628;855;227
ESCO.0722.00035;ESCO.0722.00035.0029;ESCO.0722.00035.0029i_04524;21180;22187;1007
ESCO.0722.00035;ESCO.0722.00035.0035;ESCO.0722.00035.0035b_04716;9725;9862;137
ESCO.0722.00035;ESCO.0722.00035.0081;ESCO.0722.00035.0081b_04780;3;221;218
ESCO.0722.00035;ESCO.0722.00035.0006;ESCO.0722.00035.0006i_00982;6682;7584;902
ESCO.0722.00035;ESCO.0722.00035.0008;ESCO.0722.00035.0008i_01430;24173;24763;590
ESCO.0722.00035;ESCO.0722.00035.0009;ESCO.0722.00035.0009i_01462;5959;7473;1514
ESCO.0722.00035;ESCO.0722.00035.0009;ESCO.0722.00035.0009i_01494;40370;41419;1049
ESCO.0722.00035;ESCO.0722.00035.0014;ESCO.0722.00035.0014i_02326;73589;75301;1712
ESCO.0722.00035;ESCO.0722.00035.0015;ESCO.0722.00035.0015i_02358;22435;22815;380
ESCO.0722.00035;ESCO.0722.00035.0015;ESCO.0722.00035.0015i_02390;59958;60191;233
ESCO.0722.00035;ESCO.0722.00035.0029;ESCO.0722.00035.0029i_04534;27558;27908;350
ESCO.0722.00035;ESCO.0722.00035.0091;ESCO.0722.00035.0091b_04790;3;215;212
ESCO.0722.00035;ESCO.0722.00035.0006;ESCO.0722.00035.0006i_00983;8175;8468;293
ESCO.0722.00035;ESCO.0722.00035.0008;ESCO.0722.00035.0008i_01431;24753;25034;281
ESCO.0722.00035;ESCO.0722.00035.0009;ESCO.0722.00035.0009i_01463;7528;7899;371
ESCO.0722.00035;ESCO.0722.00035.0011;ESCO.0722.00035.0011i_02167;343160;343261;101
ESCO.0722.00035;ESCO.0722.00035.0014;ESCO.0722.00035.0014i_02327;75294;76019;725
ESCO.0722.00035;ESCO.0722.00035.0015;ESCO.0722.00035.0015i_02359;23262;23465;203
ESCO.0722.00035;ESCO.0722.00035.0015;ESCO.0722.00035.0015i_02391;60563;62146;1583
ESCO.0722.00035;ESCO.0722.00035.0092;ESCO.0722.00035.0092b_04791;2;214;212
ESCO.0722.00035;ESCO.0722.00035.0006;ESCO.0722.00035.0006i_01016;35336;36655;1319
ESCO.0722.00035;ESCO.0722.00035.0008;ESCO.0722.00035.0008i_01432;25118;26398;1280
ESCO.0722.00035;ESCO.0722.00035.0009;ESCO.0722.00035.0009i_01464;8257;9117;860
ESCO.0722.00035;ESCO.0722.00035.0015;ESCO.0722.00035.0015i_02360;24354;24563;209
ESCO.0722.00035;ESCO.0722.00035.0015;ESCO.0722.00035.0015i_02392;62148;63773;1625
ESCO.0722.00035;ESCO.0722.00035.0028;ESCO.0722.00035.0028b_04472;75;572;497
ESCO.0722.00035;ESCO.0722.00035.0029;ESCO.0722.00035.0029i_04536;28214;28462;248
ESCO.0722.00035;ESCO.0722.00035.0093;ESCO.0722.00035.0093b_04792;3;212;209
ESCO.0722.00035;ESCO.0722.00035.0008;ESCO.0722.00035.0008i_01445;38405;39163;758
ESCO.0722.00035;ESCO.0722.00035.0011;ESCO.0722.00035.0011i_01957;109808;110041;233
ESCO.0722.00035;ESCO.0722.00035.0015;ESCO.0722.00035.0015i_02341;7635;8408;773
ESCO.0722.00035;ESCO.0722.00035.0015;ESCO.0722.00035.0015i_02373;34344;34718;374
ESCO.0722.00035;ESCO.0722.00035.0028;ESCO.0722.00035.0028i_04485;10468;11586;1118
ESCO.0722.00035;ESCO.0722.00035.0075;ESCO.0722.00035.0075b_04773;14;232;218
ESCO.0722.00035;ESCO.0722.00035.0003;ESCO.0722.00035.0003i_00454;475505;475810;305
ESCO.0722.00035;ESCO.0722.00035.0006;ESCO.0722.00035.0006i_01254;301504;302133;629
ESCO.0722.00035;ESCO.0722.00035.0008;ESCO.0722.00035.0008i_01414;6218;9037;2819
ESCO.0722.00035;ESCO.0722.00035.0008;ESCO.0722.00035.0008i_01446;39186;39734;548
ESCO.0722.00035;ESCO.0722.00035.0011;ESCO.0722.00035.0011i_01958;109989;110447;458
ESCO.0722.00035;ESCO.0722.00035.0015;ESCO.0722.00035.0015i_02342;8415;9122;707
ESCO.0722.00035;ESCO.0722.00035.0015;ESCO.0722.00035.0015i_02374;34823;35302;479
ESCO.0722.00035;ESCO.0722.00035.0028;ESCO.0722.00035.0028i_04486;11588;12616;1028
ESCO.0722.00035;ESCO.0722.00035.0076;ESCO.0722.00035.0076b_04774;1;132;131
ESCO.0722.00035;ESCO.0722.00035.0003;ESCO.0722.00035.0003i_00871;892986;893915;929
ESCO.0722.00035;ESCO.0722.00035.0008;ESCO.0722.00035.0008i_01447;40289;40615;326
ESCO.0722.00035;ESCO.0722.00035.0015;ESCO.0722.00035.0015i_02343;9101;9754;653
ESCO.0722.00035;ESCO.0722.00035.0015;ESCO.0722.00035.0015i_02375;35408;35785;377
ESCO.0722.00035;ESCO.0722.00035.0028;ESCO.0722.00035.0028i_04487;12603;14465;1862
ESCO.0722.00035;ESCO.0722.00035.0045;ESCO.0722.00035.0045b_04743;3;1400;1397
ESCO.0722.00035;ESCO.0722.00035.0008;ESCO.0722.00035.0008b_01456;45635;48442;2807
ESCO.0722.00035;ESCO.0722.00035.0009;ESCO.0722.00035.0009i_01488;35193;35603;410
ESCO.0722.00035;ESCO.0722.00035.0011;ESCO.0722.00035.0011i_01968;118483;119154;671
ESCO.0722.00035;ESCO.0722.00035.0015;ESCO.0722.00035.0015i_02352;15552;15917;365
ESCO.0722.00035;ESCO.0722.00035.0015;ESCO.0722.00035.0015i_02384;45832;45960;128
ESCO.0722.00035;ESCO.0722.00035.0085;ESCO.0722.00035.0085b_04784;2;196;194
ESCO.0722.00035;ESCO.0722.00035.0008;ESCO.0722.00035.0008i_01425;19353;20225;872
ESCO.0722.00035;ESCO.0722.00035.0009;ESCO.0722.00035.0009b_01457;426;2651;2225
ESCO.0722.00035;ESCO.0722.00035.0009;ESCO.0722.00035.0009i_01489;35756;36730;974
ESCO.0722.00035;ESCO.0722.00035.0014;ESCO.0722.00035.0014i_02321;69535;70413;878
ESCO.0722.00035;ESCO.0722.00035.0015;ESCO.0722.00035.0015i_02353;15914;16576;662
ESCO.0722.00035;ESCO.0722.00035.0015;ESCO.0722.00035.0015i_02385;46176;47576;1400
ESCO.0722.00035;ESCO.0722.00035.0020;ESCO.0722.00035.0020i_03441;92603;92821;218
ESCO.0722.00035;ESCO.0722.00035.0029;ESCO.0722.00035.0029i_04497;2496;3248;752
ESCO.0722.00035;ESCO.0722.00035.0087;ESCO.0722.00035.0087b_04785;3;98;95
ESCO.0722.00035;ESCO.0722.00035.0008;ESCO.0722.00035.0008i_01426;20222;20563;341
ESCO.0722.00035;ESCO.0722.00035.0009;ESCO.0722.00035.0009i_01458;2731;3171;440
ESCO.0722.00035;ESCO.0722.00035.0009;ESCO.0722.00035.0009i_01490;36740;37033;293
ESCO.0722.00035;ESCO.0722.00035.0009;ESCO.0722.00035.0009i_01618;169418;170134;716
ESCO.0722.00035;ESCO.0722.00035.0011;ESCO.0722.00035.0011i_02034;183113;183427;314
ESCO.0722.00035;ESCO.0722.00035.0014;ESCO.0722.00035.0014i_02322;70407;70667;260
ESCO.0722.00035;ESCO.0722.00035.0015;ESCO.0722.00035.0015i_02354;16576;17526;950
ESCO.0722.00035;ESCO.0722.00035.0029;ESCO.0722.00035.0029i_04498;3269;3598;329
ESCO.0722.00035;ESCO.0722.00035.0054;ESCO.0722.00035.0054b_04754;1;459;458
ESCO.0722.00035;ESCO.0722.00035.0088;ESCO.0722.00035.0088b_04786;3;68;65
ESCO.0722.00035;ESCO.0722.00035.0008;ESCO.0722.00035.0008i_01438;32666;33328;662
ESCO.0722.00035;ESCO.0722.00035.0009;ESCO.0722.00035.0009i_01470;23186;23455;269
ESCO.0722.00035;ESCO.0722.00035.0011;ESCO.0722.00035.0011i_01982;128014;128766;752
ESCO.0722.00035;ESCO.0722.00035.0015;ESCO.0722.00035.0015i_02334;1272;1964;692
ESCO.0722.00035;ESCO.0722.00035.0015;ESCO.0722.00035.0015i_02366;29537;29734;197
ESCO.0722.00035;ESCO.0722.00035.0015;ESCO.0722.00035.0015i_02398;72042;73100;1058
ESCO.0722.00035;ESCO.0722.00035.0028;ESCO.0722.00035.0028i_04478;3459;3785;326
ESCO.0722.00035;ESCO.0722.00035.0029;ESCO.0722.00035.0029i_04510;12280;13119;839
ESCO.0722.00035;ESCO.0722.00035.0107;ESCO.0722.00035.0107b_04798;2;139;137
ESCO.0722.00035;ESCO.0722.00035.0008;ESCO.0722.00035.0008i_01439;33325;34044;719
ESCO.0722.00035;ESCO.0722.00035.0009;ESCO.0722.00035.0009i_01471;23673;24059;386
ESCO.0722.00035;ESCO.0722.00035.0015;ESCO.0722.00035.0015i_02335;1980;3989;2009
ESCO.0722.00035;ESCO.0722.00035.0015;ESCO.0722.00035.0015i_02367;29972;30547;575
ESCO.0722.00035;ESCO.0722.00035.0028;ESCO.0722.00035.0028i_04479;3804;6551;2747
ESCO.0722.00035;ESCO.0722.00035.0008;ESCO.0722.00035.0008i_01440;34058;34801;743
ESCO.0722.00035;ESCO.0722.00035.0009;ESCO.0722.00035.0009i_01472;24034;24279;245
ESCO.0722.00035;ESCO.0722.00035.0011;ESCO.0722.00035.0011i_01952;106765;108096;1331
ESCO.0722.00035;ESCO.0722.00035.0015;ESCO.0722.00035.0015i_02368;30589;30747;158
ESCO.0722.00035;ESCO.0722.00035.0028;ESCO.0722.00035.0028i_04480;6563;7279;716
ESCO.0722.00035;ESCO.0722.00035.0034;ESCO.0722.00035.0034i_04704;24711;25145;434
ESCO.0722.00035;ESCO.0722.00035.0069;ESCO.0722.00035.0069b_04768;3;239;236
ESCO.0722.00043;ESCO.0722.00043.0002;ESCO.0722.00043.0002b_00941;498759;498881;122
ESCO.0722.00043;ESCO.0722.00043.0006;ESCO.0722.00043.0006i_02064;24274;25200;926
ESCO.0722.00043;ESCO.0722.00043.0074;ESCO.0722.00043.0074b_04752;2;529;527
ESCO.0722.00043;ESCO.0722.00043.0019;ESCO.0722.00043.0019b_04064;101397;101972;575
ESCO.0722.00043;ESCO.0722.00043.0045;ESCO.0722.00043.0045b_04672;5045;5275;230
ESCO.0722.00043;ESCO.0722.00043.0038;ESCO.0722.00043.0038i_04609;4890;5126;236
ESCO.0722.00043;ESCO.0722.00043.0052;ESCO.0722.00043.0052b_04705;3175;3282;107
ESCO.0722.00043;ESCO.0722.00043.0006;ESCO.0722.00043.0006i_02068;26457;26819;362
ESCO.0722.00043;ESCO.0722.00043.0043;ESCO.0722.00043.0043b_04660;5933;6613;680
ESCO.0722.00043;ESCO.0722.00043.0062;ESCO.0722.00043.0062b_04725;2;214;212
ESCO.0722.00043;ESCO.0722.00043.0097;ESCO.0722.00043.0097b_04789;264;548;284
ESCO.0722.00043;ESCO.0722.00043.0144;ESCO.0722.00043.0144b_04821;1;159;158
ESCO.0722.00043;ESCO.0722.00043.0002;ESCO.0722.00043.0002i_00918;478206;478706;500
ESCO.0722.00043;ESCO.0722.00043.0006;ESCO.0722.00043.0006i_02070;28055;28348;293
ESCO.0722.00043;ESCO.0722.00043.0098;ESCO.0722.00043.0098b_04790;1;546;545
ESCO.0722.00043;ESCO.0722.00043.0145;ESCO.0722.00043.0145b_04822;1;138;137
ESCO.0722.00043;ESCO.0722.00043.0056;ESCO.0722.00043.0056b_04712;330;761;431
ESCO.0722.00043;ESCO.0722.00043.0088;ESCO.0722.00043.0088b_04776;1;717;716
ESCO.0722.00043;ESCO.0722.00043.0011;ESCO.0722.00043.0011i_03081;38108;39019;911
ESCO.0722.00043;ESCO.0722.00043.0003;ESCO.0722.00043.0003b_00942;2;5461;5459
ESCO.0722.00043;ESCO.0722.00043.0073;ESCO.0722.00043.0073b_04750;227;319;92
ESCO.0722.00043;ESCO.0722.00043.0030;ESCO.0722.00043.0030b_04485;24619;24693;74
ESCO.0722.00043;ESCO.0722.00043.0055;ESCO.0722.00043.0055b_04710;1;1617;1616
ESCO.0722.00043;ESCO.0722.00043.0033;ESCO.0722.00043.0033b_04519;1;525;524
ESCO.0722.00043;ESCO.0722.00043.0039;ESCO.0722.00043.0039b_04623;7430;7810;380
ESCO.0722.00043;ESCO.0722.00043.0093;ESCO.0722.00043.0093b_04783;1;258;257
ESCO.0722.00043;ESCO.0722.00043.0063;ESCO.0722.00043.0063b_04729;1;207;206
ESCO.0722.00043;ESCO.0722.00043.0101;ESCO.0722.00043.0101b_04793;134;382;248
ESCO.0722.00043;ESCO.0722.00043.0149;ESCO.0722.00043.0149b_04825;1;114;113
ESCO.0722.00043;ESCO.0722.00043.0028;ESCO.0722.00043.0028b_04442;27612;28124;512
ESCO.0722.00043;ESCO.0722.00043.0045;ESCO.0722.00043.0045b_04666;2;412;410
ESCO.0722.00043;ESCO.0722.00043.0079;ESCO.0722.00043.0079i_04762;388;543;155
ESCO.0722.00043;ESCO.0722.00043.0101;ESCO.0722.00043.0101b_04794;372;512;140
ESCO.0722.00043;ESCO.0722.00043.0079;ESCO.0722.00043.0079b_04763;662;820;158
ESCO.0722.00043;ESCO.0722.00043.0099;ESCO.0722.00043.0099b_04791;3;89;86
ESCO.0722.00043;ESCO.0722.00043.0079;ESCO.0722.00043.0079b_04760;2;163;161
ESCO.0722.00043;ESCO.0722.00043.0099;ESCO.0722.00043.0099b_04792;73;546;473
ESCO.0722.00043;ESCO.0722.00043.0006;ESCO.0722.00043.0006i_02082;33513;34025;512
ESCO.0722.00043;ESCO.0722.00043.0066;ESCO.0722.00043.0066b_04738;798;1403;605
ESCO.0722.00043;ESCO.0722.00043.0005;ESCO.0722.00043.0005i_01763;58287;58937;650
ESCO.0722.00043;ESCO.0722.00043.0014;ESCO.0722.00043.0014b_03459;2;193;191
ESCO.0722.00043;ESCO.0722.00043.0038;ESCO.0722.00043.0038b_04611;8187;8687;500
ESCO.0722.00043;ESCO.0722.00043.0111;ESCO.0722.00043.0111b_04803;2;454;452
ESCO.0722.00043;ESCO.0722.00043.0131;ESCO.0722.00043.0131b_04817;1;219;218
ESCO.0722.00043;ESCO.0722.00043.0076;ESCO.0722.00043.0076b_04755;3;929;926
ESCO.0722.00043;ESCO.0722.00043.0104;ESCO.0722.00043.0104b_04796;3;494;491
ESCO.0722.00043;ESCO.0722.00043.0026;ESCO.0722.00043.0026b_04382;30919;31182;263
ESCO.0722.00043;ESCO.0722.00043.0011;ESCO.0722.00043.0011i_03082;39041;39331;290
ESCO.0722.00043;ESCO.0722.00043.0057;ESCO.0722.00043.0057b_04714;2;2026;2024
ESCO.0722.00043;ESCO.0722.00043.0089;ESCO.0722.00043.0089b_04778;417;689;272
ESCO.0722.00043;ESCO.0722.00043.0121;ESCO.0722.00043.0121b_04810;1;309;308
ESCO.0722.00053;ESCO.0722.00053.0027;ESCO.0722.00053.0027i_04148;39700;39945;245
ESCO.0722.00053;ESCO.0722.00053.0061;ESCO.0722.00053.0061b_04564;10;225;215
ESCO.0722.00053;ESCO.0722.00053.0003;ESCO.0722.00053.0003i_00727;52867;53679;812
ESCO.0722.00053;ESCO.0722.00053.0009;ESCO.0722.00053.0009i_01943;22081;23226;1145
ESCO.0722.00053;ESCO.0722.00053.0018;ESCO.0722.00053.0018i_02999;63728;65416;1688
ESCO.0722.00053;ESCO.0722.00053.0025;ESCO.0722.00053.0025i_03927;40374;40751;377
ESCO.0722.00053;ESCO.0722.00053.0027;ESCO.0722.00053.0027i_04183;73355;74275;920
ESCO.0722.00053;ESCO.0722.00053.0027;ESCO.0722.00053.0027i_04215;100315;100968;653
ESCO.0722.00053;ESCO.0722.00053.0064;ESCO.0722.00053.0064b_04567;3;215;212
ESCO.0722.00053;ESCO.0722.00053.0027;ESCO.0722.00053.0027i_04198;85958;86758;800
ESCO.0722.00053;ESCO.0722.00053.0099;ESCO.0722.00053.0099b_04582;3;83;80
ESCO.0722.00053;ESCO.0722.00053.0100;ESCO.0722.00053.0100b_04583;3;83;80
ESCO.0722.00053;ESCO.0722.00053.0002;ESCO.0722.00053.0002i_00648;35778;35981;203
ESCO.0722.00053;ESCO.0722.00053.0027;ESCO.0722.00053.0027i_04168;53247;57272;4025
ESCO.0722.00053;ESCO.0722.00053.0070;ESCO.0722.00053.0070b_04571;124;207;83
ESCO.0722.00053;ESCO.0722.00053.0030;ESCO.0722.00053.0030i_04399;33408;33890;482
ESCO.0722.00053;ESCO.0722.00053.0056;ESCO.0722.00053.0056b_04560;2;187;185
ESCO.0722.00053;ESCO.0722.00053.0027;ESCO.0722.00053.0027i_04149;39942;40292;350
ESCO.0722.00053;ESCO.0722.00053.0062;ESCO.0722.00053.0062b_04565;3;221;218
ESCO.0722.00053;ESCO.0722.00053.0013;ESCO.0722.00053.0013i_02476;31588;31989;401
ESCO.0722.00053;ESCO.0722.00053.0027;ESCO.0722.00053.0027i_04204;89909;90190;281
ESCO.0722.00053;ESCO.0722.00053.0030;ESCO.0722.00053.0030i_04396;32120;32227;107
ESCO.0722.00053;ESCO.0722.00053.0013;ESCO.0722.00053.0013i_02477;32003;32533;530
ESCO.0722.00053;ESCO.0722.00053.0030;ESCO.0722.00053.0030i_04397;32208;32516;308
ESCO.0722.00053;ESCO.0722.00053.0030;ESCO.0722.00053.0030i_04398;32513;33424;911
ESCO.0722.00053;ESCO.0722.00053.0017;ESCO.0722.00053.0017b_02902;3;338;335
ESCO.0722.00053;ESCO.0722.00053.0027;ESCO.0722.00053.0027i_04214;99653;100318;665
ESCO.0722.00053;ESCO.0722.00053.0063;ESCO.0722.00053.0063b_04566;2;217;215
ESCO.0722.00053;ESCO.0722.00053.0019;ESCO.0722.00053.0019i_03200;73192;73749;557
ESCO.0722.00053;ESCO.0722.00053.0027;ESCO.0722.00053.0027i_04160;48649;49404;755
ESCO.0722.00053;ESCO.0722.00053.0002;ESCO.0722.00053.0002i_00642;31696;32901;1205
ESCO.0722.00053;ESCO.0722.00053.0040;ESCO.0722.00053.0040b_04546;1166;1531;365
ESCO.0722.00053;ESCO.0722.00053.0027;ESCO.0722.00053.0027i_04126;18095;19150;1055
ESCO.0722.00053;ESCO.0722.00053.0075;ESCO.0722.00053.0075b_04574;3;152;149
ESCO.0722.00053;ESCO.0722.00053.0019;ESCO.0722.00053.0019i_03199;72515;73201;686
ESCO.0722.00053;ESCO.0722.00053.0025;ESCO.0722.00053.0025i_03913;20710;21144;434
ESCO.0722.00053;ESCO.0722.00053.0030;ESCO.0722.00053.0030i_04393;30954;31205;251
ESCO.0722.00053;ESCO.0722.00053.0027;ESCO.0722.00053.0027i_04138;28108;28671;563
ESCO.0722.00053;ESCO.0722.00053.0030;ESCO.0722.00053.0030i_04394;31264;31713;449
ESCO.0722.00053;ESCO.0722.00053.0027;ESCO.0722.00053.0027b_04107;2;85;83
ESCO.0722.00053;ESCO.0722.00053.0027;ESCO.0722.00053.0027i_04203;89753;89893;140
ESCO.0722.00053;ESCO.0722.00053.0003;ESCO.0722.00053.0003i_00728;53767;55110;1343
ESCO.0722.00053;ESCO.0722.00053.0009;ESCO.0722.00053.0009i_01944;23223;23837;614
ESCO.0722.00053;ESCO.0722.00053.0025;ESCO.0722.00053.0025i_03928;40723;40983;260
ESCO.0722.00053;ESCO.0722.00053.0027;ESCO.0722.00053.0027i_04216;100968;101153;185
ESCO.0722.00053;ESCO.0722.00053.0065;ESCO.0722.00053.0065b_04568;1;213;212
ESCO.0722.00053;ESCO.0722.00053.0068;ESCO.0722.00053.0068b_04569;2;208;206
ESCO.0722.00053;ESCO.0722.00053.0027;ESCO.0722.00053.0027i_04218;101707;102258;551
ESCO.0722.00053;ESCO.0722.00053.0069;ESCO.0722.00053.0069b_04570;1;207;206
ESCO.0722.00053;ESCO.0722.00053.0030;ESCO.0722.00053.0030i_04355;4873;6870;1997
ESCO.0722.00053;ESCO.0722.00053.0027;ESCO.0722.00053.0027i_04132;22085;22285;200
ESCO.0722.00053;ESCO.0722.00053.0030;ESCO.0722.00053.0030i_04356;6870;8258;1388
ESCO.0722.00053;ESCO.0722.00053.0027;ESCO.0722.00053.0027i_04133;22379;24718;2339
ESCO.0722.00053;ESCO.0722.00053.0027;ESCO.0722.00053.0027i_04197;85713;85811;98
ESCO.0722.00053;ESCO.0722.00053.0027;ESCO.0722.00053.0027i_04209;93892;94626;734
ESCO.0722.00053;ESCO.0722.00053.0030;ESCO.0722.00053.0030i_04401;34394;34909;515
ESCO.0722.00053;ESCO.0722.00053.0027;ESCO.0722.00053.0027i_04146;38961;39515;554
ESCO.0722.00053;ESCO.0722.00053.0030;ESCO.0722.00053.0030i_04370;19211;19381;170
ESCO.0722.00053;ESCO.0722.00053.0059;ESCO.0722.00053.0059b_04562;38;229;191
ESCO.0722.00053;ESCO.0722.00053.0027;ESCO.0722.00053.0027i_04147;39472;39618;146
ESCO.0722.00053;ESCO.0722.00053.0030;ESCO.0722.00053.0030i_04371;19668;20186;518
ESCO.0722.00053;ESCO.0722.00053.0030;ESCO.0722.00053.0030i_04403;35459;36262;803
ESCO.0722.00053;ESCO.0722.00053.0060;ESCO.0722.00053.0060b_04563;2;226;224
ESCO.0722.00085;ESCO.0722.00085.0012;ESCO.0722.00085.0012i_01836;27209;29002;1793
ESCO.0722.00085;ESCO.0722.00085.0025;ESCO.0722.00085.0025i_03407;113281;113580;299
ESCO.0722.00085;ESCO.0722.00085.0034;ESCO.0722.00085.0034i_04126;42170;42304;134
ESCO.0722.00085;ESCO.0722.00085.0025;ESCO.0722.00085.0025i_03423;124439;125296;857
ESCO.0722.00085;ESCO.0722.00085.0031;ESCO.0722.00085.0031b_03903;4061;5809;1748
ESCO.0722.00085;ESCO.0722.00085.0045;ESCO.0722.00085.0045i_04511;2869;3177;308
ESCO.0722.00085;ESCO.0722.00085.0025;ESCO.0722.00085.0025i_03424;125283;126539;1256
ESCO.0722.00085;ESCO.0722.00085.0045;ESCO.0722.00085.0045b_04512;3134;3616;482
ESCO.0722.00085;ESCO.0722.00085.0034;ESCO.0722.00085.0034b_04083;1;243;242
ESCO.0722.00085;ESCO.0722.00085.0065;ESCO.0722.00085.0065b_04531;3;71;68
ESCO.0722.00085;ESCO.0722.00085.0065;ESCO.0722.00085.0065b_04532;111;227;116
ESCO.0722.00085;ESCO.0722.00085.0034;ESCO.0722.00085.0034i_04149;64365;64994;629
ESCO.0722.00085;ESCO.0722.00085.0069;ESCO.0722.00085.0069b_04533;3;188;185
ESCO.0722.00085;ESCO.0722.00085.0028;ESCO.0722.00085.0028i_03693;113066;113464;398
ESCO.0722.00085;ESCO.0722.00085.0107;ESCO.0722.00085.0107b_04548;2;67;65
ESCO.0722.00085;ESCO.0722.00085.0025;ESCO.0722.00085.0025i_03429;129076;130491;1415
ESCO.0722.00085;ESCO.0722.00085.0028;ESCO.0722.00085.0028i_03694;113466;114074;608
ESCO.0722.00085;ESCO.0722.00085.0023;ESCO.0722.00085.0023i_03064;10572;10949;377
ESCO.0722.00085;ESCO.0722.00085.0032;ESCO.0722.00085.0032i_03992;91063;91755;692
ESCO.0722.00085;ESCO.0722.00085.0034;ESCO.0722.00085.0034i_04152;67040;68380;1340
ESCO.0722.00085;ESCO.0722.00085.0032;ESCO.0722.00085.0032i_03993;91901;92533;632
ESCO.0722.00085;ESCO.0722.00085.0081;ESCO.0722.00085.0081b_04538;3;143;140
ESCO.0722.00085;ESCO.0722.00085.0072;ESCO.0722.00085.0072b_04534;1;69;68
ESCO.0722.00085;ESCO.0722.00085.0023;ESCO.0722.00085.0023i_03063;10240;10575;335
ESCO.0722.00085;ESCO.0722.00085.0099;ESCO.0722.00085.0099b_04545;3;80;77
ESCO.0722.00085;ESCO.0722.00085.0103;ESCO.0722.00085.0103b_04546;3;74;71
ESCO.0722.00085;ESCO.0722.00085.0025;ESCO.0722.00085.0025i_03408;113689;114495;806
ESCO.0722.00085;ESCO.0722.00085.0063;ESCO.0722.00085.0063b_04529;1;231;230
ESCO.0722.00085;ESCO.0722.00085.0064;ESCO.0722.00085.0064b_04530;53;181;128
ESCO.0722.00085;ESCO.0722.00085.0011;ESCO.0722.00085.0011i_01787;286326;286823;497
ESCO.0722.00085;ESCO.0722.00085.0011;ESCO.0722.00085.0011i_01788;286894;287439;545
ESCO.0722.00085;ESCO.0722.00085.0034;ESCO.0722.00085.0034i_04124;39049;39651;602
ESCO.0722.00085;ESCO.0722.00085.0020;ESCO.0722.00085.0020i_02569;11572;11682;110
ESCO.0722.00085;ESCO.0722.00085.0028;ESCO.0722.00085.0028i_03691;112337;112768;431
ESCO.0722.00085;ESCO.0722.00085.0034;ESCO.0722.00085.0034i_04139;54132;54584;452
ESCO.0722.00129;ESCO.0722.00129.0001;ESCO.0722.00129.0001i_00263;294012;294524;512
ESCO.0722.00129;ESCO.0722.00129.0011;ESCO.0722.00129.0011i_02535;164717;164974;257
ESCO.0722.00129;ESCO.0722.00129.0016;ESCO.0722.00129.0016i_03143;104526;105077;551
ESCO.0722.00129;ESCO.0722.00129.0016;ESCO.0722.00129.0016i_03175;120190;120330;140
ESCO.0722.00129;ESCO.0722.00129.0016;ESCO.0722.00129.0016i_03207;142231;144813;2582
ESCO.0722.00129;ESCO.0722.00129.0020;ESCO.0722.00129.0020i_03623;19907;20434;527
ESCO.0722.00129;ESCO.0722.00129.0020;ESCO.0722.00129.0020i_03687;96574;97440;866
ESCO.0722.00129;ESCO.0722.00129.0190;ESCO.0722.00129.0190b_05031;2;223;221
ESCO.0722.00129;ESCO.0722.00129.0234;ESCO.0722.00129.0234b_05063;1;99;98
ESCO.0722.00129;ESCO.0722.00129.0020;ESCO.0722.00129.0020i_03626;22412;22789;377
ESCO.0722.00129;ESCO.0722.00129.0047;ESCO.0722.00129.0047b_04778;4875;6527;1652
ESCO.0722.00129;ESCO.0722.00129.0070;ESCO.0722.00129.0070b_04874;436;2256;1820
ESCO.0722.00129;ESCO.0722.00129.0082;ESCO.0722.00129.0082b_04906;1;1365;1364
ESCO.0722.00129;ESCO.0722.00129.0193;ESCO.0722.00129.0193b_05034;1;219;218
ESCO.0722.00129;ESCO.0722.00129.0002;ESCO.0722.00129.0002i_00409;2512;3129;617
ESCO.0722.00129;ESCO.0722.00129.0016;ESCO.0722.00129.0016i_03161;115315;115614;299
ESCO.0722.00129;ESCO.0722.00129.0016;ESCO.0722.00129.0016i_03193;131565;131966;401
ESCO.0722.00129;ESCO.0722.00129.0002;ESCO.0722.00129.0002i_00410;3140;3466;326
ESCO.0722.00129;ESCO.0722.00129.0013;ESCO.0722.00129.0013i_02810;101142;101735;593
ESCO.0722.00129;ESCO.0722.00129.0016;ESCO.0722.00129.0016i_03162;115611;115808;197
ESCO.0722.00129;ESCO.0722.00129.0016;ESCO.0722.00129.0016i_03194;131966;132139;173
ESCO.0722.00129;ESCO.0722.00129.0023;ESCO.0722.00129.0023i_03962;42860;42970;110
ESCO.0722.00129;ESCO.0722.00129.0025;ESCO.0722.00129.0025b_04122;213;3158;2945
ESCO.0722.00129;ESCO.0722.00129.0091;ESCO.0722.00129.0091b_04922;878;994;116
ESCO.0722.00129;ESCO.0722.00129.0144;ESCO.0722.00129.0144b_04986;1;315;314
ESCO.0722.00129;ESCO.0722.00129.0213;ESCO.0722.00129.0213b_05050;3;152;149
ESCO.0722.00129;ESCO.0722.00129.0002;ESCO.0722.00129.0002i_00411;3471;4382;911
ESCO.0722.00129;ESCO.0722.00129.0013;ESCO.0722.00129.0013i_02811;101772;102500;728
ESCO.0722.00129;ESCO.0722.00129.0016;ESCO.0722.00129.0016i_03163;115805;116410;605
ESCO.0722.00129;ESCO.0722.00129.0016;ESCO.0722.00129.0016i_03182;123154;123372;218
ESCO.0722.00129;ESCO.0722.00129.0024;ESCO.0722.00129.0024i_04046;22592;23035;443
ESCO.0722.00129;ESCO.0722.00129.0164;ESCO.0722.00129.0164b_05006;2;73;71
ESCO.0722.00129;ESCO.0722.00129.0242;ESCO.0722.00129.0242b_05070;3;77;74
ESCO.0722.00129;ESCO.0722.00129.0004;ESCO.0722.00129.0004i_00943;232216;233049;833
ESCO.0722.00129;ESCO.0722.00129.0016;ESCO.0722.00129.0016i_03183;123376;124008;632
ESCO.0722.00129;ESCO.0722.00129.0023;ESCO.0722.00129.0023i_03951;29052;30443;1391
ESCO.0722.00129;ESCO.0722.00129.0024;ESCO.0722.00129.0024i_04015;1287;1622;335
ESCO.0722.00129;ESCO.0722.00129.0024;ESCO.0722.00129.0024i_04047;23038;23529;491
ESCO.0722.00129;ESCO.0722.00129.0048;ESCO.0722.00129.0048i_04783;1945;2526;581
ESCO.0722.00129;ESCO.0722.00129.0200;ESCO.0722.00129.0200b_05039;1;207;206
ESCO.0722.00129;ESCO.0722.00129.0243;ESCO.0722.00129.0243b_05071;1;75;74
ESCO.0722.00129;ESCO.0722.00129.0004;ESCO.0722.00129.0004i_00944;233068;233706;638
ESCO.0722.00129;ESCO.0722.00129.0006;ESCO.0722.00129.0006i_01552;289958;290275;317
ESCO.0722.00129;ESCO.0722.00129.0012;ESCO.0722.00129.0012i_02672;145434;145745;311
ESCO.0722.00129;ESCO.0722.00129.0016;ESCO.0722.00129.0016i_03152;109086;109595;509
ESCO.0722.00129;ESCO.0722.00129.0016;ESCO.0722.00129.0016i_03184;124039;124494;455
ESCO.0722.00129;ESCO.0722.00129.0024;ESCO.0722.00129.0024i_04016;1675;2079;404
ESCO.0722.00129;ESCO.0722.00129.0048;ESCO.0722.00129.0048i_04784;3296;5257;1961
ESCO.0722.00129;ESCO.0722.00129.0201;ESCO.0722.00129.0201b_05040;3;206;203
ESCO.0722.00129;ESCO.0722.00129.0016;ESCO.0722.00129.0016i_03137;102632;102871;239
ESCO.0722.00129;ESCO.0722.00129.0016;ESCO.0722.00129.0016i_03201;135105;135317;212
ESCO.0722.00129;ESCO.0722.00129.0019;ESCO.0722.00129.0019i_03521;37540;38241;701
ESCO.0722.00129;ESCO.0722.00129.0020;ESCO.0722.00129.0020i_03617;13517;14596;1079
ESCO.0722.00129;ESCO.0722.00129.0020;ESCO.0722.00129.0020i_03681;90821;91636;815
ESCO.0722.00129;ESCO.0722.00129.0024;ESCO.0722.00129.0024i_04065;37692;37988;296
ESCO.0722.00129;ESCO.0722.00129.0025;ESCO.0722.00129.0025i_04129;5952;6518;566
ESCO.0722.00129;ESCO.0722.00129.0007;ESCO.0722.00129.0007i_01730;189522;190373;851
ESCO.0722.00129;ESCO.0722.00129.0012;ESCO.0722.00129.0012i_02626;86919;87383;464
ESCO.0722.00129;ESCO.0722.00129.0016;ESCO.0722.00129.0016i_03138;102849;103505;656
ESCO.0722.00129;ESCO.0722.00129.0016;ESCO.0722.00129.0016i_03202;135432;138362;2930
ESCO.0722.00129;ESCO.0722.00129.0019;ESCO.0722.00129.0019i_03522;38266;39612;1346
ESCO.0722.00129;ESCO.0722.00129.0020;ESCO.0722.00129.0020i_03682;91638;92636;998
ESCO.0722.00129;ESCO.0722.00129.0025;ESCO.0722.00129.0025i_04130;6694;7044;350
ESCO.0722.00129;ESCO.0722.00129.0047;ESCO.0722.00129.0047b_04770;3;80;77
ESCO.0722.00129;ESCO.0722.00129.0078;ESCO.0722.00129.0078b_04898;1481;1570;89
ESCO.0722.00129;ESCO.0722.00129.0121;ESCO.0722.00129.0121b_04962;2;427;425
ESCO.0722.00129;ESCO.0722.00129.0004;ESCO.0722.00129.0004i_00835;129808;130104;296
ESCO.0722.00129;ESCO.0722.00129.0012;ESCO.0722.00129.0012i_02627;87331;87897;566
ESCO.0722.00129;ESCO.0722.00129.0016;ESCO.0722.00129.0016i_03139;103517;103738;221
ESCO.0722.00129;ESCO.0722.00129.0016;ESCO.0722.00129.0016i_03203;138362;138859;497
ESCO.0722.00129;ESCO.0722.00129.0020;ESCO.0722.00129.0020i_03683;92629;93885;1256
ESCO.0722.00129;ESCO.0722.00129.0185;ESCO.0722.00129.0185b_05027;1;228;227
ESCO.0722.00129;ESCO.0722.00129.0001;ESCO.0722.00129.0001i_00264;294843;296435;1592
ESCO.0722.00129;ESCO.0722.00129.0011;ESCO.0722.00129.0011i_02536;165084;165371;287
ESCO.0722.00129;ESCO.0722.00129.0016;ESCO.0722.00129.0016i_03144;105074;105226;152
ESCO.0722.00129;ESCO.0722.00129.0016;ESCO.0722.00129.0016i_03176;120455;120856;401
ESCO.0722.00129;ESCO.0722.00129.0016;ESCO.0722.00129.0016i_03208;144850;145848;998
ESCO.0722.00129;ESCO.0722.00129.0020;ESCO.0722.00129.0020i_03624;20856;21698;842
ESCO.0722.00129;ESCO.0722.00129.0235;ESCO.0722.00129.0235b_05064;2;97;95
ESCO.0722.00129;ESCO.0722.00129.0016;ESCO.0722.00129.0016i_03167;117276;117473;197
ESCO.0722.00129;ESCO.0722.00129.0016;ESCO.0722.00129.0016i_03199;133622;134365;743
ESCO.0722.00129;ESCO.0722.00129.0040;ESCO.0722.00129.0040b_04703;16821;17009;188
ESCO.0722.00129;ESCO.0722.00129.0043;ESCO.0722.00129.0043b_04735;2;184;182
ESCO.0722.00129;ESCO.0722.00129.0077;ESCO.0722.00129.0077b_04895;1171;1584;413
ESCO.0722.00129;ESCO.0722.00129.0181;ESCO.0722.00129.0181b_05023;3;230;227
ESCO.0722.00129;ESCO.0722.00129.0004;ESCO.0722.00129.0004i_00864;157100;157867;767
ESCO.0722.00129;ESCO.0722.00129.0016;ESCO.0722.00129.0016i_03136;102398;102622;224
ESCO.0722.00129;ESCO.0722.00129.0016;ESCO.0722.00129.0016i_03200;134423;135091;668
ESCO.0722.00129;ESCO.0722.00129.0020;ESCO.0722.00129.0020i_03680;90216;90758;542
ESCO.0722.00129;ESCO.0722.00129.0025;ESCO.0722.00129.0025i_04128;5494;5943;449
ESCO.0722.00129;ESCO.0722.00129.0025;ESCO.0722.00129.0025i_04160;27408;27722;314
ESCO.0722.00129;ESCO.0722.00129.0041;ESCO.0722.00129.0041b_04704;2;103;101
ESCO.0722.00129;ESCO.0722.00129.0058;ESCO.0722.00129.0058b_04832;3965;4126;161
ESCO.0722.00129;ESCO.0722.00129.0067;ESCO.0722.00129.0067b_04864;1;558;557
ESCO.0722.00129;ESCO.0722.00129.0119;ESCO.0722.00129.0119b_04960;152;436;284
ESCO.0722.00129;ESCO.0722.00129.0150;ESCO.0722.00129.0150b_04992;1;213;212
ESCO.0722.00129;ESCO.0722.00129.0182;ESCO.0722.00129.0182b_05024;99;230;131
ESCO.0722.00129;ESCO.0722.00129.0224;ESCO.0722.00129.0224b_05056;2;115;113
ESCO.0722.00129;ESCO.0722.00129.0007;ESCO.0722.00129.0007i_01729;188671;189507;836
ESCO.0722.00129;ESCO.0722.00129.0008;ESCO.0722.00129.0008b_01801;239;775;536
ESCO.0722.00129;ESCO.0722.00129.0016;ESCO.0722.00129.0016i_03145;105223;105651;428
ESCO.0722.00129;ESCO.0722.00129.0016;ESCO.0722.00129.0016i_03177;120853;121128;275
ESCO.0722.00129;ESCO.0722.00129.0016;ESCO.0722.00129.0016i_03209;146288;146659;371
ESCO.0722.00129;ESCO.0722.00129.0041;ESCO.0722.00129.0041i_04713;7316;7609;293
ESCO.0722.00129;ESCO.0722.00129.0060;ESCO.0722.00129.0060b_04841;3050;3781;731
ESCO.0722.00129;ESCO.0722.00129.0016;ESCO.0722.00129.0016i_03155;111097;111789;692
ESCO.0722.00129;ESCO.0722.00129.0016;ESCO.0722.00129.0016i_03187;126082;127431;1349
ESCO.0722.00129;ESCO.0722.00129.0023;ESCO.0722.00129.0023i_03923;1250;2245;995
ESCO.0722.00129;ESCO.0722.00129.0024;ESCO.0722.00129.0024i_04019;3047;3298;251
ESCO.0722.00129;ESCO.0722.00129.0024;ESCO.0722.00129.0024i_04051;27708;28001;293
ESCO.0722.00129;ESCO.0722.00129.0048;ESCO.0722.00129.0048i_04787;6179;6529;350
ESCO.0722.00129;ESCO.0722.00129.0016;ESCO.0722.00129.0016i_03156;111917;112168;251
ESCO.0722.00129;ESCO.0722.00129.0016;ESCO.0722.00129.0016i_03188;127391;128317;926
ESCO.0722.00129;ESCO.0722.00129.0024;ESCO.0722.00129.0024i_04020;3405;3845;440
ESCO.0722.00129;ESCO.0722.00129.0024;ESCO.0722.00129.0024i_04052;28089;28877;788
ESCO.0722.00129;ESCO.0722.00129.0205;ESCO.0722.00129.0205b_05044;3;179;176
ESCO.0722.00129;ESCO.0722.00129.0016;ESCO.0722.00129.0016i_03157;112198;112764;566
ESCO.0722.00129;ESCO.0722.00129.0016;ESCO.0722.00129.0016i_03189;128321;129643;1322
ESCO.0722.00129;ESCO.0722.00129.0024;ESCO.0722.00129.0024i_04053;28874;29071;197
ESCO.0722.00129;ESCO.0722.00129.0074;ESCO.0722.00129.0074b_04885;1866;1979;113
ESCO.0722.00129;ESCO.0722.00129.0170;ESCO.0722.00129.0170b_05013;3;134;131
ESCO.0722.00129;ESCO.0722.00129.0006;ESCO.0722.00129.0006i_01393;103430;104308;878
ESCO.0722.00129;ESCO.0722.00129.0006;ESCO.0722.00129.0006i_01553;290272;290967;695
ESCO.0722.00129;ESCO.0722.00129.0016;ESCO.0722.00129.0016i_03153;109970;110182;212
ESCO.0722.00129;ESCO.0722.00129.0016;ESCO.0722.00129.0016i_03185;124491;125738;1247
ESCO.0722.00129;ESCO.0722.00129.0025;ESCO.0722.00129.0025i_04177;36193;36765;572
ESCO.0722.00129;ESCO.0722.00129.0048;ESCO.0722.00129.0048i_04785;5614;5883;269
ESCO.0722.00129;ESCO.0722.00129.0202;ESCO.0722.00129.0202b_05041;3;200;197
ESCO.0722.00129;ESCO.0722.00129.0006;ESCO.0722.00129.0006i_01394;104483;104719;236
ESCO.0722.00129;ESCO.0722.00129.0016;ESCO.0722.00129.0016i_03154;110585;111061;476
ESCO.0722.00129;ESCO.0722.00129.0016;ESCO.0722.00129.0016i_03186;125798;126031;233
ESCO.0722.00129;ESCO.0722.00129.0024;ESCO.0722.00129.0024i_04082;49171;50871;1700
ESCO.0722.00129;ESCO.0722.00129.0025;ESCO.0722.00129.0025i_04178;36765;36959;194
ESCO.0722.00129;ESCO.0722.00129.0109;ESCO.0722.00129.0109b_04946;1;513;512
ESCO.0722.00129;ESCO.0722.00129.0203;ESCO.0722.00129.0203b_05042;3;194;191
ESCO.0722.00129;ESCO.0722.00129.0246;ESCO.0722.00129.0246b_05074;3;71;68
ESCO.0722.00129;ESCO.0722.00129.0004;ESCO.0722.00129.0004b_01020;310391;310738;347
ESCO.0722.00129;ESCO.0722.00129.0016;ESCO.0722.00129.0016i_03164;116444;116626;182
ESCO.0722.00129;ESCO.0722.00129.0016;ESCO.0722.00129.0016i_03196;132362;132712;350
ESCO.0722.00129;ESCO.0722.00129.0018;ESCO.0722.00129.0018i_03388;34096;34479;383
ESCO.0722.00129;ESCO.0722.00129.0025;ESCO.0722.00129.0025i_04156;26203;26622;419
ESCO.0722.00129;ESCO.0722.00129.0016;ESCO.0722.00129.0016i_03197;132715;133179;464
ESCO.0722.00129;ESCO.0722.00129.0025;ESCO.0722.00129.0025i_04157;26625;26801;176
ESCO.0722.00129;ESCO.0722.00129.0065;ESCO.0722.00129.0065b_04861;2464;2643;179
ESCO.0722.00129;ESCO.0722.00129.0217;ESCO.0722.00129.0217b_05053;29;142;113
ESCO.0722.00129;ESCO.0722.00129.0004;ESCO.0722.00129.0004i_00862;154596;154811;215
ESCO.0722.00129;ESCO.0722.00129.0016;ESCO.0722.00129.0016i_03166;116897;117157;260
ESCO.0722.00129;ESCO.0722.00129.0016;ESCO.0722.00129.0016i_03198;133176;133559;383
ESCO.0722.00129;ESCO.0722.00129.0042;ESCO.0722.00129.0042b_04734;11827;12456;629
ESCO.0722.00129;ESCO.0722.00129.0117;ESCO.0722.00129.0117b_04958;1;390;389
ESCO.0722.00129;ESCO.0722.00129.0180;ESCO.0722.00129.0180b_05022;3;230;227
ESCO.0722.00129;ESCO.0722.00129.0016;ESCO.0722.00129.0016i_03147;106528;107373;845
ESCO.0722.00129;ESCO.0722.00129.0016;ESCO.0722.00129.0016i_03179;121569;121955;386
ESCO.0722.00129;ESCO.0722.00129.0016;ESCO.0722.00129.0016i_03148;107392;107676;284
ESCO.0722.00129;ESCO.0722.00129.0016;ESCO.0722.00129.0016i_03180;122379;122924;545
ESCO.0722.00129;ESCO.0722.00129.0016;ESCO.0722.00129.0016i_03212;148685;148789;104
ESCO.0722.00129;ESCO.0722.00129.0023;ESCO.0722.00129.0023i_03948;26213;26833;620
ESCO.0722.00129;ESCO.0722.00129.0024;ESCO.0722.00129.0024i_04044;21275;22018;743
ESCO.0722.00129;ESCO.0722.00129.0103;ESCO.0722.00129.0103b_04940;540;629;89
ESCO.0722.00129;ESCO.0722.00129.0162;ESCO.0722.00129.0162b_05004;3;254;251
ESCO.0722.00129;ESCO.0722.00129.0195;ESCO.0722.00129.0195b_05036;5;217;212
ESCO.0722.00129;ESCO.0722.00129.0240;ESCO.0722.00129.0240b_05068;2;82;80
ESCO.0722.00129;ESCO.0722.00129.0016;ESCO.0722.00129.0016i_03181;123009;123161;152
ESCO.0722.00129;ESCO.0722.00129.0019;ESCO.0722.00129.0019i_03597;123580;124449;869
ESCO.0722.00129;ESCO.0722.00129.0023;ESCO.0722.00129.0023i_03949;26846;27379;533
ESCO.0722.00129;ESCO.0722.00129.0196;ESCO.0722.00129.0196b_05037;3;215;212
ESCO.0722.00129;ESCO.0722.00129.0004;ESCO.0722.00129.0004i_00854;149073;149621;548
ESCO.0722.00129;ESCO.0722.00129.0016;ESCO.0722.00129.0016i_03158;112764;113000;236
ESCO.0722.00129;ESCO.0722.00129.0016;ESCO.0722.00129.0016i_03190;129656;130105;449
ESCO.0722.00129;ESCO.0722.00129.0024;ESCO.0722.00129.0024i_04054;29618;30841;1223
ESCO.0722.00129;ESCO.0722.00129.0090;ESCO.0722.00129.0090b_04918;2;178;176
ESCO.0722.00129;ESCO.0722.00129.0139;ESCO.0722.00129.0139b_04982;2;325;323
ESCO.0722.00129;ESCO.0722.00129.0250;ESCO.0722.00129.0250b_05078;3;68;65
ESCO.0722.00129;ESCO.0722.00129.0004;ESCO.0722.00129.0004i_00855;151011;151199;188
ESCO.0722.00129;ESCO.0722.00129.0016;ESCO.0722.00129.0016i_03159;112993;113892;899
ESCO.0722.00129;ESCO.0722.00129.0016;ESCO.0722.00129.0016i_03191;130123;131199;1076
ESCO.0722.00129;ESCO.0722.00129.0024;ESCO.0722.00129.0024i_04087;53434;55059;1625
ESCO.0722.00129;ESCO.0722.00129.0209;ESCO.0722.00129.0209b_05047;2;163;161
ESCO.0722.00129;ESCO.0722.00129.0016;ESCO.0722.00129.0016i_03192;131209;131502;293
ESCO.0722.00129;ESCO.0722.00129.0024;ESCO.0722.00129.0024i_04088;55059;55661;602
ESCO.0722.00129;ESCO.0722.00129.0090;ESCO.0722.00129.0090b_04920;574;1002;428
ESCO.0722.00129;ESCO.0722.00129.0142;ESCO.0722.00129.0142b_04984;1;321;320
ESCO.0722.00129;ESCO.0722.00129.0016;ESCO.0722.00129.0016i_03140;103830;104021;191
ESCO.0722.00129;ESCO.0722.00129.0016;ESCO.0722.00129.0016i_03172;118941;119081;140
ESCO.0722.00129;ESCO.0722.00129.0016;ESCO.0722.00129.0016i_03204;138859;139329;470
ESCO.0722.00129;ESCO.0722.00129.0020;ESCO.0722.00129.0020i_03684;93878;94849;971
ESCO.0722.00129;ESCO.0722.00129.0024;ESCO.0722.00129.0024i_04068;38896;40305;1409
ESCO.0722.00129;ESCO.0722.00129.0025;ESCO.0722.00129.0025i_04132;9074;10525;1451
ESCO.0722.00129;ESCO.0722.00129.0016;ESCO.0722.00129.0016i_03141;104018;104314;296
ESCO.0722.00129;ESCO.0722.00129.0016;ESCO.0722.00129.0016i_03173;119078;119767;689
ESCO.0722.00129;ESCO.0722.00129.0016;ESCO.0722.00129.0016i_03205;139292;139708;416
ESCO.0722.00129;ESCO.0722.00129.0020;ESCO.0722.00129.0020i_03685;94842;95933;1091
ESCO.0722.00129;ESCO.0722.00129.0052;ESCO.0722.00129.0052i_04805;734;1246;512
ESCO.0722.00129;ESCO.0722.00129.0187;ESCO.0722.00129.0187b_05029;3;227;224
ESCO.0722.00129;ESCO.0722.00129.0016;ESCO.0722.00129.0016i_03142;104311;104529;218
ESCO.0722.00129;ESCO.0722.00129.0016;ESCO.0722.00129.0016i_03174;119874;120200;326
ESCO.0722.00129;ESCO.0722.00129.0016;ESCO.0722.00129.0016i_03206;139695;142172;2477
ESCO.0722.00129;ESCO.0722.00129.0020;ESCO.0722.00129.0020i_03686;95899;96429;530
ESCO.0722.00129;ESCO.0722.00129.0060;ESCO.0722.00129.0060b_04838;2;874;872
ESCO.0722.00129;ESCO.0722.00129.0156;ESCO.0722.00129.0156b_04998;1;270;269
ESCO.0722.00140;ESCO.0722.00140.0010;ESCO.0722.00140.0010i_01457;13978;14157;179
ESCO.0722.00140;ESCO.0722.00140.0029;ESCO.0722.00140.0029b_03537;176954;177415;461
ESCO.0722.00140;ESCO.0722.00140.0047;ESCO.0722.00140.0047i_04465;12678;12929;251
ESCO.0722.00140;ESCO.0722.00140.0083;ESCO.0722.00140.0083b_04561;3;236;233
ESCO.0722.00140;ESCO.0722.00140.0121;ESCO.0722.00140.0121b_04593;1;192;191
ESCO.0722.00140;ESCO.0722.00140.0163;ESCO.0722.00140.0163b_04625;2;205;203
ESCO.0722.00140;ESCO.0722.00140.0048;ESCO.0722.00140.0048i_04468;1814;2653;839
ESCO.0722.00140;ESCO.0722.00140.0086;ESCO.0722.00140.0086b_04564;30;236;206
ESCO.0722.00140;ESCO.0722.00140.0124;ESCO.0722.00140.0124b_04596;1;84;83
ESCO.0722.00140;ESCO.0722.00140.0167;ESCO.0722.00140.0167b_04628;3;182;179
ESCO.0722.00140;ESCO.0722.00140.0106;ESCO.0722.00140.0106b_04579;2;64;62
ESCO.0722.00140;ESCO.0722.00140.0143;ESCO.0722.00140.0143b_04611;2;208;206
ESCO.0722.00140;ESCO.0722.00140.0041;ESCO.0722.00140.0041i_04324;36947;37549;602
ESCO.0722.00140;ESCO.0722.00140.0106;ESCO.0722.00140.0106b_04580;77;226;149
ESCO.0722.00140;ESCO.0722.00140.0144;ESCO.0722.00140.0144b_04612;3;209;206
ESCO.0722.00140;ESCO.0722.00140.0208;ESCO.0722.00140.0208b_04644;2;79;77
ESCO.0722.00140;ESCO.0722.00140.0041;ESCO.0722.00140.0041i_04325;37551;38189;638
ESCO.0722.00140;ESCO.0722.00140.0053;ESCO.0722.00140.0053b_04517;4699;4827;128
ESCO.0722.00140;ESCO.0722.00140.0107;ESCO.0722.00140.0107b_04581;1;225;224
ESCO.0722.00140;ESCO.0722.00140.0145;ESCO.0722.00140.0145b_04613;2;208;206
ESCO.0722.00140;ESCO.0722.00140.0092;ESCO.0722.00140.0092b_04568;3;74;71
ESCO.0722.00140;ESCO.0722.00140.0128;ESCO.0722.00140.0128b_04600;2;70;68
ESCO.0722.00140;ESCO.0722.00140.0038;ESCO.0722.00140.0038i_04153;40676;41809;1133
ESCO.0722.00140;ESCO.0722.00140.0041;ESCO.0722.00140.0041i_04313;31885;32136;251
ESCO.0722.00140;ESCO.0722.00140.0130;ESCO.0722.00140.0130b_04601;3;212;209
ESCO.0722.00140;ESCO.0722.00140.0041;ESCO.0722.00140.0041i_04314;32179;32718;539
ESCO.0722.00140;ESCO.0722.00140.0131;ESCO.0722.00140.0131b_04602;1;213;212
ESCO.0722.00140;ESCO.0722.00140.0027;ESCO.0722.00140.0027i_03179;6963;7727;764
ESCO.0722.00140;ESCO.0722.00140.0115;ESCO.0722.00140.0115b_04587;3;221;218
ESCO.0722.00140;ESCO.0722.00140.0153;ESCO.0722.00140.0153b_04619;2;208;206
ESCO.0722.00140;ESCO.0722.00140.0027;ESCO.0722.00140.0027i_03180;7908;9071;1163
ESCO.0722.00140;ESCO.0722.00140.0116;ESCO.0722.00140.0116b_04588;48;221;173
ESCO.0722.00140;ESCO.0722.00140.0157;ESCO.0722.00140.0157b_04620;24;206;182
ESCO.0722.00140;ESCO.0722.00140.0027;ESCO.0722.00140.0027i_03181;9076;9624;548
ESCO.0722.00140;ESCO.0722.00140.0079;ESCO.0722.00140.0079b_04557;135;239;104
ESCO.0722.00140;ESCO.0722.00140.0117;ESCO.0722.00140.0117b_04589;1;138;137
ESCO.0722.00140;ESCO.0722.00140.0158;ESCO.0722.00140.0158b_04621;3;206;203
ESCO.0722.00140;ESCO.0722.00140.0041;ESCO.0722.00140.0041i_04274;5556;5765;209
ESCO.0722.00140;ESCO.0722.00140.0047;ESCO.0722.00140.0047b_04466;12965;13513;548
ESCO.0722.00140;ESCO.0722.00140.0084;ESCO.0722.00140.0084b_04562;2;238;236
ESCO.0722.00140;ESCO.0722.00140.0122;ESCO.0722.00140.0122b_04594;3;218;215
ESCO.0722.00140;ESCO.0722.00140.0165;ESCO.0722.00140.0165b_04626;78;206;128
ESCO.0722.00140;ESCO.0722.00140.0075;ESCO.0722.00140.0075b_04553;2;109;107
ESCO.0722.00140;ESCO.0722.00140.0113;ESCO.0722.00140.0113b_04585;3;224;221
ESCO.0722.00140;ESCO.0722.00140.0151;ESCO.0722.00140.0151b_04617;3;209;206
ESCO.0722.00140;ESCO.0722.00140.0075;ESCO.0722.00140.0075b_04554;119;253;134
ESCO.0722.00140;ESCO.0722.00140.0114;ESCO.0722.00140.0114b_04586;3;152;149
ESCO.0722.00140;ESCO.0722.00140.0152;ESCO.0722.00140.0152b_04618;3;209;206
ESCO.0722.00140;ESCO.0722.00140.0041;ESCO.0722.00140.0041i_04275;5740;5925;185
ESCO.0722.00140;ESCO.0722.00140.0048;ESCO.0722.00140.0048b_04467;1160;1777;617
ESCO.0722.00140;ESCO.0722.00140.0085;ESCO.0722.00140.0085b_04563;1;183;182
ESCO.0722.00140;ESCO.0722.00140.0123;ESCO.0722.00140.0123b_04595;1;219;218
ESCO.0722.00140;ESCO.0722.00140.0166;ESCO.0722.00140.0166b_04627;3;206;203
ESCO.0722.00140;ESCO.0722.00140.0041;ESCO.0722.00140.0041i_04317;34718;34849;131
ESCO.0722.00140;ESCO.0722.00140.0043;ESCO.0722.00140.0043i_04349;10824;12134;1310
ESCO.0722.00140;ESCO.0722.00140.0098;ESCO.0722.00140.0098b_04573;2;202;200
ESCO.0722.00140;ESCO.0722.00140.0135;ESCO.0722.00140.0135b_04605;87;212;125
ESCO.0722.00140;ESCO.0722.00140.0138;ESCO.0722.00140.0138b_04606;2;211;209
ESCO.0722.00140;ESCO.0722.00140.0192;ESCO.0722.00140.0192b_04638;1;111;110
ESCO.0722.00140;ESCO.0722.00140.0101;ESCO.0722.00140.0101b_04575;161;226;65
ESCO.0722.00140;ESCO.0722.00140.0139;ESCO.0722.00140.0139b_04607;3;209;206
ESCO.0722.00140;ESCO.0722.00140.0096;ESCO.0722.00140.0096b_04571;2;229;227
ESCO.0722.00140;ESCO.0722.00140.0132;ESCO.0722.00140.0132b_04603;1;213;212
ESCO.0722.00140;ESCO.0722.00140.0041;ESCO.0722.00140.0041i_04316;33725;34693;968
ESCO.0722.00140;ESCO.0722.00140.0097;ESCO.0722.00140.0097b_04572;2;229;227
ESCO.0722.00140;ESCO.0722.00140.0134;ESCO.0722.00140.0134b_04604;3;212;209
ESCO.0722.00140;ESCO.0722.00140.0109;ESCO.0722.00140.0109b_04582;2;223;221
ESCO.0722.00140;ESCO.0722.00140.0146;ESCO.0722.00140.0146b_04614;3;125;122
ESCO.0722.00140;ESCO.0722.00140.0214;ESCO.0722.00140.0214b_04646;3;74;71
ESCO.0722.00140;ESCO.0722.00140.0110;ESCO.0722.00140.0110b_04583;1;225;224
ESCO.0722.00140;ESCO.0722.00140.0147;ESCO.0722.00140.0147b_04615;2;208;206
ESCO.0722.00140;ESCO.0722.00140.0074;ESCO.0722.00140.0074b_04552;1;204;203
ESCO.0722.00140;ESCO.0722.00140.0111;ESCO.0722.00140.0111b_04584;146;223;77
ESCO.0722.00140;ESCO.0722.00140.0148;ESCO.0722.00140.0148b_04616;3;209;206
ESCO.0722.00140;ESCO.0722.00140.0027;ESCO.0722.00140.0027i_03189;14928;15215;287
ESCO.0722.00140;ESCO.0722.00140.0048;ESCO.0722.00140.0048i_04469;2690;3598;908
ESCO.0722.00140;ESCO.0722.00140.0125;ESCO.0722.00140.0125b_04597;3;218;215
ESCO.0722.00140;ESCO.0722.00140.0170;ESCO.0722.00140.0170b_04629;3;206;203
ESCO.0722.00140;ESCO.0722.00140.0017;ESCO.0722.00140.0017b_02230;33005;33253;248
ESCO.0722.00140;ESCO.0722.00140.0027;ESCO.0722.00140.0027i_03190;15218;15442;224
ESCO.0722.00140;ESCO.0722.00140.0036;ESCO.0722.00140.0036i_04054;12525;13115;590
ESCO.0722.00140;ESCO.0722.00140.0041;ESCO.0722.00140.0041i_04278;8653;10002;1349
ESCO.0722.00140;ESCO.0722.00140.0048;ESCO.0722.00140.0048i_04470;3637;3906;269
ESCO.0722.00140;ESCO.0722.00140.0088;ESCO.0722.00140.0088b_04566;3;236;233
ESCO.0722.00140;ESCO.0722.00140.0126;ESCO.0722.00140.0126b_04598;1;216;215
ESCO.0722.00140;ESCO.0722.00140.0171;ESCO.0722.00140.0171b_04630;1;204;203
ESCO.0722.00140;ESCO.0722.00140.0027;ESCO.0722.00140.0027i_03191;15435;15725;290
ESCO.0722.00140;ESCO.0722.00140.0036;ESCO.0722.00140.0036i_04055;13177;13572;395
ESCO.0722.00140;ESCO.0722.00140.0048;ESCO.0722.00140.0048i_04471;4117;5784;1667
ESCO.0722.00140;ESCO.0722.00140.0091;ESCO.0722.00140.0091b_04567;1;63;62
ESCO.0722.00140;ESCO.0722.00140.0127;ESCO.0722.00140.0127b_04599;3;215;212
ESCO.0722.00140;ESCO.0722.00140.0010;ESCO.0722.00140.0010i_01472;23187;24674;1487
ESCO.0722.00140;ESCO.0722.00140.0032;ESCO.0722.00140.0032i_03744;90543;92228;1685
ESCO.0722.00140;ESCO.0722.00140.0038;ESCO.0722.00140.0038i_04160;47979;49784;1805
ESCO.0722.00140;ESCO.0722.00140.0102;ESCO.0722.00140.0102b_04576;1;189;188
ESCO.0722.00140;ESCO.0722.00140.0140;ESCO.0722.00140.0140b_04608;2;211;209
ESCO.0722.00140;ESCO.0722.00140.0032;ESCO.0722.00140.0032i_03745;92244;92891;647
ESCO.0722.00140;ESCO.0722.00140.0104;ESCO.0722.00140.0104b_04577;1;228;227
ESCO.0722.00140;ESCO.0722.00140.0141;ESCO.0722.00140.0141b_04609;74;211;137
ESCO.0722.00140;ESCO.0722.00140.0198;ESCO.0722.00140.0198b_04641;3;98;95
ESCO.0722.00140;ESCO.0722.00140.0025;ESCO.0722.00140.0025i_02978;14359;14601;242
ESCO.0722.00140;ESCO.0722.00140.0105;ESCO.0722.00140.0105b_04578;3;227;224
ESCO.0722.00140;ESCO.0722.00140.0142;ESCO.0722.00140.0142b_04610;11;211;200
ESCO.0722.00140;ESCO.0722.00140.0027;ESCO.0722.00140.0027i_03182;9688;9882;194
ESCO.0722.00140;ESCO.0722.00140.0041;ESCO.0722.00140.0041i_04270;3621;3929;308
ESCO.0722.00140;ESCO.0722.00140.0041;ESCO.0722.00140.0041i_04302;25591;25950;359
ESCO.0722.00140;ESCO.0722.00140.0080;ESCO.0722.00140.0080b_04558;1;240;239
ESCO.0722.00140;ESCO.0722.00140.0118;ESCO.0722.00140.0118b_04590;13;219;206
ESCO.0722.00140;ESCO.0722.00140.0160;ESCO.0722.00140.0160b_04622;1;207;206
ESCO.0722.00140;ESCO.0722.00140.0047;ESCO.0722.00140.0047i_04463;11582;12310;728
ESCO.0722.00140;ESCO.0722.00140.0081;ESCO.0722.00140.0081b_04559;1;237;236
ESCO.0722.00140;ESCO.0722.00140.0119;ESCO.0722.00140.0119b_04591;2;220;218
ESCO.0722.00140;ESCO.0722.00140.0161;ESCO.0722.00140.0161b_04623;77;208;131
ESCO.0722.00140;ESCO.0722.00140.0041;ESCO.0722.00140.0041i_04272;5062;5202;140
ESCO.0722.00140;ESCO.0722.00140.0047;ESCO.0722.00140.0047i_04464;12392;12670;278
ESCO.0722.00140;ESCO.0722.00140.0120;ESCO.0722.00140.0120b_04592;2;220;218
ESCO.0722.00140;ESCO.0722.00140.0162;ESCO.0722.00140.0162b_04624;30;206;176
ESCO.0722.00149;ESCO.0722.00149.0031;ESCO.0722.00149.0031i_04094;5371;5796;425
ESCO.0722.00149;ESCO.0722.00149.0031;ESCO.0722.00149.0031i_04126;32046;33287;1241
ESCO.0722.00149;ESCO.0722.00149.0031;ESCO.0722.00149.0031i_04158;59942;60898;956
ESCO.0722.00149;ESCO.0722.00149.0031;ESCO.0722.00149.0031i_04190;99543;100091;548
ESCO.0722.00149;ESCO.0722.00149.0035;ESCO.0722.00149.0035i_04414;28730;30421;1691
ESCO.0722.00149;ESCO.0722.00149.0037;ESCO.0722.00149.0037i_04510;744;2003;1259
ESCO.0722.00149;ESCO.0722.00149.0037;ESCO.0722.00149.0037i_04542;31817;32518;701
ESCO.0722.00149;ESCO.0722.00149.0065;ESCO.0722.00149.0065i_04958;1775;2182;407
ESCO.0722.00149;ESCO.0722.00149.0024;ESCO.0722.00149.0024i_03425;75743;76408;665
ESCO.0722.00149;ESCO.0722.00149.0031;ESCO.0722.00149.0031i_04129;34987;36027;1040
ESCO.0722.00149;ESCO.0722.00149.0031;ESCO.0722.00149.0031i_04161;63064;63999;935
ESCO.0722.00149;ESCO.0722.00149.0035;ESCO.0722.00149.0035i_04417;31085;31366;281
ESCO.0722.00149;ESCO.0722.00149.0037;ESCO.0722.00149.0037i_04513;3636;4058;422
ESCO.0722.00149;ESCO.0722.00149.0037;ESCO.0722.00149.0037i_04545;34781;34957;176
ESCO.0722.00149;ESCO.0722.00149.0065;ESCO.0722.00149.0065i_04961;3356;3661;305
ESCO.0722.00149;ESCO.0722.00149.0001;ESCO.0722.00149.0001i_00176;198845;200944;2099
ESCO.0722.00149;ESCO.0722.00149.0031;ESCO.0722.00149.0031i_04112;18125;18331;206
ESCO.0722.00149;ESCO.0722.00149.0031;ESCO.0722.00149.0031i_04144;47792;48832;1040
ESCO.0722.00149;ESCO.0722.00149.0031;ESCO.0722.00149.0031i_04176;80964;82022;1058
ESCO.0722.00149;ESCO.0722.00149.0035;ESCO.0722.00149.0035i_04400;15953;17308;1355
ESCO.0722.00149;ESCO.0722.00149.0035;ESCO.0722.00149.0035i_04432;47125;49515;2390
ESCO.0722.00149;ESCO.0722.00149.0037;ESCO.0722.00149.0037i_04528;18714;21860;3146
ESCO.0722.00149;ESCO.0722.00149.0037;ESCO.0722.00149.0037i_04560;46851;47027;176
ESCO.0722.00149;ESCO.0722.00149.0044;ESCO.0722.00149.0044i_04784;15733;16551;818
ESCO.0722.00149;ESCO.0722.00149.0055;ESCO.0722.00149.0055i_04912;4652;4876;224
ESCO.0722.00149;ESCO.0722.00149.0062;ESCO.0722.00149.0062i_04944;992;1624;632
ESCO.0722.00149;ESCO.0722.00149.0187;ESCO.0722.00149.0187b_05104;2;106;104
ESCO.0722.00149;ESCO.0722.00149.0031;ESCO.0722.00149.0031i_04113;18392;19717;1325
ESCO.0722.00149;ESCO.0722.00149.0031;ESCO.0722.00149.0031i_04145;48832;50469;1637
ESCO.0722.00149;ESCO.0722.00149.0031;ESCO.0722.00149.0031i_04177;82028;82162;134
ESCO.0722.00149;ESCO.0722.00149.0035;ESCO.0722.00149.0035i_04401;17298;17759;461
ESCO.0722.00149;ESCO.0722.00149.0035;ESCO.0722.00149.0035i_04433;49949;50419;470
ESCO.0722.00149;ESCO.0722.00149.0037;ESCO.0722.00149.0037i_04529;21860;23944;2084
ESCO.0722.00149;ESCO.0722.00149.0037;ESCO.0722.00149.0037i_04561;47081;47392;311
ESCO.0722.00149;ESCO.0722.00149.0044;ESCO.0722.00149.0044i_04785;16756;16923;167
ESCO.0722.00149;ESCO.0722.00149.0051;ESCO.0722.00149.0051i_04881;6979;7437;458
ESCO.0722.00149;ESCO.0722.00149.0055;ESCO.0722.00149.0055i_04913;4873;5610;737
ESCO.0722.00149;ESCO.0722.00149.0062;ESCO.0722.00149.0062i_04945;1636;2538;902
ESCO.0722.00149;ESCO.0722.00149.0069;ESCO.0722.00149.0069i_04977;900;1640;740
ESCO.0722.00149;ESCO.0722.00149.0106;ESCO.0722.00149.0106b_05041;1;174;173
ESCO.0722.00149;ESCO.0722.00149.0190;ESCO.0722.00149.0190b_05105;2;100;98
ESCO.0722.00149;ESCO.0722.00149.0018;ESCO.0722.00149.0018i_02802;22828;23040;212
ESCO.0722.00149;ESCO.0722.00149.0031;ESCO.0722.00149.0031i_04114;19722;20018;296
ESCO.0722.00149;ESCO.0722.00149.0031;ESCO.0722.00149.0031i_04146;50438;51994;1556
ESCO.0722.00149;ESCO.0722.00149.0031;ESCO.0722.00149.0031i_04178;82164;83675;1511
ESCO.0722.00149;ESCO.0722.00149.0033;ESCO.0722.00149.0033i_04306;26550;27215;665
ESCO.0722.00149;ESCO.0722.00149.0035;ESCO.0722.00149.0035i_04402;17761;19032;1271
ESCO.0722.00149;ESCO.0722.00149.0035;ESCO.0722.00149.0035i_04434;50469;50765;296
ESCO.0722.00149;ESCO.0722.00149.0037;ESCO.0722.00149.0037i_04530;23944;25053;1109
ESCO.0722.00149;ESCO.0722.00149.0037;ESCO.0722.00149.0037i_04562;47615;47815;200
ESCO.0722.00149;ESCO.0722.00149.0049;ESCO.0722.00149.0049i_04850;5344;5991;647
ESCO.0722.00149;ESCO.0722.00149.0055;ESCO.0722.00149.0055b_04914;5717;6208;491
ESCO.0722.00149;ESCO.0722.00149.0062;ESCO.0722.00149.0062i_04946;2800;3561;761
ESCO.0722.00149;ESCO.0722.00149.0069;ESCO.0722.00149.0069i_04978;1627;3150;1523
ESCO.0722.00149;ESCO.0722.00149.0145;ESCO.0722.00149.0145b_05074;3;188;185
ESCO.0722.00149;ESCO.0722.00149.0192;ESCO.0722.00149.0192b_05106;2;97;95
ESCO.0722.00149;ESCO.0722.00149.0031;ESCO.0722.00149.0031i_04133;38587;39645;1058
ESCO.0722.00149;ESCO.0722.00149.0031;ESCO.0722.00149.0031i_04165;67163;67384;221
ESCO.0722.00149;ESCO.0722.00149.0035;ESCO.0722.00149.0035i_04389;706;1743;1037
ESCO.0722.00149;ESCO.0722.00149.0035;ESCO.0722.00149.0035i_04421;37471;38127;656
ESCO.0722.00149;ESCO.0722.00149.0037;ESCO.0722.00149.0037i_04517;6028;6585;557
ESCO.0722.00149;ESCO.0722.00149.0037;ESCO.0722.00149.0037i_04549;37567;37770;203
ESCO.0722.00149;ESCO.0722.00149.0044;ESCO.0722.00149.0044i_04773;8340;8594;254
ESCO.0722.00149;ESCO.0722.00149.0051;ESCO.0722.00149.0051b_04869;36;260;224
ESCO.0722.00149;ESCO.0722.00149.0053;ESCO.0722.00149.0053b_04901;5579;5716;137
ESCO.0722.00149;ESCO.0722.00149.0076;ESCO.0722.00149.0076b_04997;720;1361;641
ESCO.0722.00149;ESCO.0722.00149.0001;ESCO.0722.00149.0001i_00102;109608;110486;878
ESCO.0722.00149;ESCO.0722.00149.0031;ESCO.0722.00149.0031i_04134;39655;40797;1142
ESCO.0722.00149;ESCO.0722.00149.0031;ESCO.0722.00149.0031i_04166;67457;69463;2006
ESCO.0722.00149;ESCO.0722.00149.0035;ESCO.0722.00149.0035i_04390;2107;3054;947
ESCO.0722.00149;ESCO.0722.00149.0035;ESCO.0722.00149.0035i_04422;39153;41573;2420
ESCO.0722.00149;ESCO.0722.00149.0037;ESCO.0722.00149.0037i_04518;6709;7770;1061
ESCO.0722.00149;ESCO.0722.00149.0037;ESCO.0722.00149.0037i_04550;38052;38372;320
ESCO.0722.00149;ESCO.0722.00149.0044;ESCO.0722.00149.0044i_04774;8640;8873;233
ESCO.0722.00149;ESCO.0722.00149.0054;ESCO.0722.00149.0054b_04902;1;126;125
ESCO.0722.00149;ESCO.0722.00149.0001;ESCO.0722.00149.0001i_00103;110556;110876;320
ESCO.0722.00149;ESCO.0722.00149.0031;ESCO.0722.00149.0031i_04103;10516;10728;212
ESCO.0722.00149;ESCO.0722.00149.0031;ESCO.0722.00149.0031i_04135;40790;41563;773
ESCO.0722.00149;ESCO.0722.00149.0031;ESCO.0722.00149.0031i_04167;69540;70667;1127
ESCO.0722.00149;ESCO.0722.00149.0035;ESCO.0722.00149.0035i_04391;3051;3887;836
ESCO.0722.00149;ESCO.0722.00149.0035;ESCO.0722.00149.0035i_04423;42038;42625;587
ESCO.0722.00149;ESCO.0722.00149.0037;ESCO.0722.00149.0037i_04519;7780;8286;506
ESCO.0722.00149;ESCO.0722.00149.0037;ESCO.0722.00149.0037i_04551;38981;39139;158
ESCO.0722.00149;ESCO.0722.00149.0044;ESCO.0722.00149.0044i_04775;8932;9189;257
ESCO.0722.00149;ESCO.0722.00149.0054;ESCO.0722.00149.0054i_04903;309;1355;1046
ESCO.0722.00149;ESCO.0722.00149.0031;ESCO.0722.00149.0031i_04088;1897;2133;236
ESCO.0722.00149;ESCO.0722.00149.0031;ESCO.0722.00149.0031i_04120;26120;28159;2039
ESCO.0722.00149;ESCO.0722.00149.0031;ESCO.0722.00149.0031i_04152;56377;57357;980
ESCO.0722.00149;ESCO.0722.00149.0031;ESCO.0722.00149.0031i_04184;90697;92235;1538
ESCO.0722.00149;ESCO.0722.00149.0035;ESCO.0722.00149.0035i_04408;23054;24106;1052
ESCO.0722.00149;ESCO.0722.00149.0035;ESCO.0722.00149.0035i_04440;54515;55765;1250
ESCO.0722.00149;ESCO.0722.00149.0037;ESCO.0722.00149.0037i_04536;28333;28617;284
ESCO.0722.00149;ESCO.0722.00149.0037;ESCO.0722.00149.0037i_04568;50713;50940;227
ESCO.0722.00149;ESCO.0722.00149.0071;ESCO.0722.00149.0071b_04984;711;2330;1619
ESCO.0722.00149;ESCO.0722.00149.0152;ESCO.0722.00149.0152b_05080;24;209;185
ESCO.0722.00149;ESCO.0722.00149.0001;ESCO.0722.00149.0001i_00121;129214;129486;272
ESCO.0722.00149;ESCO.0722.00149.0031;ESCO.0722.00149.0031i_04089;2159;2452;293
ESCO.0722.00149;ESCO.0722.00149.0031;ESCO.0722.00149.0031i_04121;29403;29744;341
ESCO.0722.00149;ESCO.0722.00149.0031;ESCO.0722.00149.0031i_04153;57430;57876;446
ESCO.0722.00149;ESCO.0722.00149.0031;ESCO.0722.00149.0031i_04185;92235;94874;2639
ESCO.0722.00149;ESCO.0722.00149.0035;ESCO.0722.00149.0035i_04409;24126;24326;200
ESCO.0722.00149;ESCO.0722.00149.0035;ESCO.0722.00149.0035i_04441;56060;56380;320
ESCO.0722.00149;ESCO.0722.00149.0037;ESCO.0722.00149.0037i_04537;28974;29273;299
ESCO.0722.00149;ESCO.0722.00149.0037;ESCO.0722.00149.0037i_04569;51115;52008;893
ESCO.0722.00149;ESCO.0722.00149.0056;ESCO.0722.00149.0056b_04921;5043;5483;440
ESCO.0722.00149;ESCO.0722.00149.0153;ESCO.0722.00149.0153b_05081;3;209;206
ESCO.0722.00149;ESCO.0722.00149.0001;ESCO.0722.00149.0001i_00122;129490;129765;275
ESCO.0722.00149;ESCO.0722.00149.0007;ESCO.0722.00149.0007i_01562;347782;348831;1049
ESCO.0722.00149;ESCO.0722.00149.0031;ESCO.0722.00149.0031i_04090;2630;3034;404
ESCO.0722.00149;ESCO.0722.00149.0031;ESCO.0722.00149.0031i_04122;29836;30027;191
ESCO.0722.00149;ESCO.0722.00149.0031;ESCO.0722.00149.0031i_04154;57893;58429;536
ESCO.0722.00149;ESCO.0722.00149.0031;ESCO.0722.00149.0031i_04186;94874;95551;677
ESCO.0722.00149;ESCO.0722.00149.0035;ESCO.0722.00149.0035i_04410;24323;25039;716
ESCO.0722.00149;ESCO.0722.00149.0035;ESCO.0722.00149.0035i_04442;56623;56949;326
ESCO.0722.00149;ESCO.0722.00149.0037;ESCO.0722.00149.0037i_04538;29706;30074;368
ESCO.0722.00149;ESCO.0722.00149.0037;ESCO.0722.00149.0037b_04570;51998;52309;311
ESCO.0722.00149;ESCO.0722.00149.0049;ESCO.0722.00149.0049b_04858;12074;12538;464
ESCO.0722.00149;ESCO.0722.00149.0072;ESCO.0722.00149.0072i_04986;692;1360;668
ESCO.0722.00149;ESCO.0722.00149.0154;ESCO.0722.00149.0154b_05082;3;206;203
ESCO.0722.00149;ESCO.0722.00149.0031;ESCO.0722.00149.0031i_04095;6049;6408;359
ESCO.0722.00149;ESCO.0722.00149.0031;ESCO.0722.00149.0031i_04127;33716;34291;575
ESCO.0722.00149;ESCO.0722.00149.0031;ESCO.0722.00149.0031i_04159;61070;62008;938
ESCO.0722.00149;ESCO.0722.00149.0031;ESCO.0722.00149.0031b_04191;100130;101236;1106
ESCO.0722.00149;ESCO.0722.00149.0035;ESCO.0722.00149.0035i_04415;30418;30594;176
ESCO.0722.00149;ESCO.0722.00149.0037;ESCO.0722.00149.0037i_04511;2049;2858;809
ESCO.0722.00149;ESCO.0722.00149.0037;ESCO.0722.00149.0037i_04543;32833;33114;281
ESCO.0722.00149;ESCO.0722.00149.0065;ESCO.0722.00149.0065i_04959;2382;2558;176
ESCO.0722.00149;ESCO.0722.00149.0213;ESCO.0722.00149.0213b_05119;3;68;65
ESCO.0722.00149;ESCO.0722.00149.0003;ESCO.0722.00149.0003i_00598;169881;171362;1481
ESCO.0722.00149;ESCO.0722.00149.0031;ESCO.0722.00149.0031i_04086;676;1341;665
ESCO.0722.00149;ESCO.0722.00149.0031;ESCO.0722.00149.0031i_04118;23824;24216;392
ESCO.0722.00149;ESCO.0722.00149.0031;ESCO.0722.00149.0031i_04150;55182;55511;329
ESCO.0722.00149;ESCO.0722.00149.0031;ESCO.0722.00149.0031i_04182;89439;89864;425
ESCO.0722.00149;ESCO.0722.00149.0035;ESCO.0722.00149.0035i_04406;21076;21276;200
ESCO.0722.00149;ESCO.0722.00149.0035;ESCO.0722.00149.0035i_04438;53323;53580;257
ESCO.0722.00149;ESCO.0722.00149.0037;ESCO.0722.00149.0037i_04534;27654;27776;122
ESCO.0722.00149;ESCO.0722.00149.0037;ESCO.0722.00149.0037i_04566;49386;49697;311
ESCO.0722.00149;ESCO.0722.00149.0049;ESCO.0722.00149.0049i_04854;8154;8657;503
ESCO.0722.00149;ESCO.0722.00149.0150;ESCO.0722.00149.0150b_05078;3;212;209
ESCO.0722.00149;ESCO.0722.00149.0199;ESCO.0722.00149.0199b_05110;3;89;86
ESCO.0722.00149;ESCO.0722.00149.0001;ESCO.0722.00149.0001i_00119;127862;128197;335
ESCO.0722.00149;ESCO.0722.00149.0031;ESCO.0722.00149.0031i_04087;1401;1856;455
ESCO.0722.00149;ESCO.0722.00149.0031;ESCO.0722.00149.0031i_04119;25137;26123;986
ESCO.0722.00149;ESCO.0722.00149.0031;ESCO.0722.00149.0031i_04151;55462;56367;905
ESCO.0722.00149;ESCO.0722.00149.0031;ESCO.0722.00149.0031i_04183;89854;90306;452
ESCO.0722.00149;ESCO.0722.00149.0035;ESCO.0722.00149.0035i_04407;21702;22577;875
ESCO.0722.00149;ESCO.0722.00149.0035;ESCO.0722.00149.0035i_04439;53736;54344;608
ESCO.0722.00149;ESCO.0722.00149.0037;ESCO.0722.00149.0037i_04535;27914;28267;353
ESCO.0722.00149;ESCO.0722.00149.0037;ESCO.0722.00149.0037i_04567;50214;50534;320
ESCO.0722.00149;ESCO.0722.00149.0049;ESCO.0722.00149.0049i_04855;8789;9181;392
ESCO.0722.00149;ESCO.0722.00149.0071;ESCO.0722.00149.0071b_04983;158;634;476
ESCO.0722.00149;ESCO.0722.00149.0151;ESCO.0722.00149.0151b_05079;2;211;209
ESCO.0722.00149;ESCO.0722.00149.0201;ESCO.0722.00149.0201b_05111;3;83;80
ESCO.0722.00149;ESCO.0722.00149.0031;ESCO.0722.00149.0031i_04128;34360;34938;578
ESCO.0722.00149;ESCO.0722.00149.0031;ESCO.0722.00149.0031i_04160;62075;62995;920
ESCO.0722.00149;ESCO.0722.00149.0035;ESCO.0722.00149.0035i_04416;30643;31098;455
ESCO.0722.00149;ESCO.0722.00149.0037;ESCO.0722.00149.0037i_04512;2965;3576;611
ESCO.0722.00149;ESCO.0722.00149.0037;ESCO.0722.00149.0037i_04544;33180;34364;1184
ESCO.0722.00149;ESCO.0722.00149.0044;ESCO.0722.00149.0044i_04768;4516;5343;827
ESCO.0722.00149;ESCO.0722.00149.0065;ESCO.0722.00149.0065i_04960;2640;3311;671
ESCO.0722.00149;ESCO.0722.00149.0074;ESCO.0722.00149.0074b_04992;2;358;356
ESCO.0722.00149;ESCO.0722.00149.0001;ESCO.0722.00149.0001i_00106;114881;116074;1193
ESCO.0722.00149;ESCO.0722.00149.0001;ESCO.0722.00149.0001i_00170;190282;190452;170
ESCO.0722.00149;ESCO.0722.00149.0003;ESCO.0722.00149.0003i_00618;186236;186814;578
ESCO.0722.00149;ESCO.0722.00149.0011;ESCO.0722.00149.0011i_01930;34290;34523;233
ESCO.0722.00149;ESCO.0722.00149.0014;ESCO.0722.00149.0014i_02410;38701;38913;212
ESCO.0722.00149;ESCO.0722.00149.0031;ESCO.0722.00149.0031i_04106;14301;14735;434
ESCO.0722.00149;ESCO.0722.00149.0031;ESCO.0722.00149.0031i_04138;43611;44819;1208
ESCO.0722.00149;ESCO.0722.00149.0031;ESCO.0722.00149.0031i_04170;72152;73129;977
ESCO.0722.00149;ESCO.0722.00149.0035;ESCO.0722.00149.0035i_04394;4849;5853;1004
ESCO.0722.00149;ESCO.0722.00149.0035;ESCO.0722.00149.0035i_04426;43868;44632;764
ESCO.0722.00149;ESCO.0722.00149.0037;ESCO.0722.00149.0037i_04522;13773;14819;1046
ESCO.0722.00149;ESCO.0722.00149.0037;ESCO.0722.00149.0037i_04554;40000;40923;923
ESCO.0722.00149;ESCO.0722.00149.0044;ESCO.0722.00149.0044i_04778;10524;11039;515
ESCO.0722.00149;ESCO.0722.00149.0054;ESCO.0722.00149.0054i_04906;3822;5177;1355
ESCO.0722.00149;ESCO.0722.00149.0068;ESCO.0722.00149.0068b_04970;116;445;329
ESCO.0722.00149;ESCO.0722.00149.0079;ESCO.0722.00149.0079b_05002;1;372;371
ESCO.0722.00149;ESCO.0722.00149.0136;ESCO.0722.00149.0136b_05066;2;229;227
ESCO.0722.00149;ESCO.0722.00149.0001;ESCO.0722.00149.0001i_00107;116061;117485;1424
ESCO.0722.00149;ESCO.0722.00149.0003;ESCO.0722.00149.0003i_00619;187022;187111;89
ESCO.0722.00149;ESCO.0722.00149.0014;ESCO.0722.00149.0014i_02411;39018;39239;221
ESCO.0722.00149;ESCO.0722.00149.0031;ESCO.0722.00149.0031i_04107;14826;15239;413
ESCO.0722.00149;ESCO.0722.00149.0031;ESCO.0722.00149.0031i_04139;44837;45304;467
ESCO.0722.00149;ESCO.0722.00149.0031;ESCO.0722.00149.0031i_04171;73190;73567;377
ESCO.0722.00149;ESCO.0722.00149.0035;ESCO.0722.00149.0035i_04395;5850;7103;1253
ESCO.0722.00149;ESCO.0722.00149.0035;ESCO.0722.00149.0035i_04427;44955;45479;524
ESCO.0722.00149;ESCO.0722.00149.0037;ESCO.0722.00149.0037i_04523;15411;15923;512
ESCO.0722.00149;ESCO.0722.00149.0037;ESCO.0722.00149.0037i_04555;41123;41695;572
ESCO.0722.00149;ESCO.0722.00149.0044;ESCO.0722.00149.0044i_04779;11254;12681;1427
ESCO.0722.00149;ESCO.0722.00149.0049;ESCO.0722.00149.0049b_04843;3;1223;1220
ESCO.0722.00149;ESCO.0722.00149.0054;ESCO.0722.00149.0054i_04907;5232;5459;227
ESCO.0722.00149;ESCO.0722.00149.0068;ESCO.0722.00149.0068i_04971;599;2011;1412
ESCO.0722.00149;ESCO.0722.00149.0079;ESCO.0722.00149.0079i_05003;376;1251;875
ESCO.0722.00149;ESCO.0722.00149.0178;ESCO.0722.00149.0178b_05099;3;110;107
ESCO.0722.00149;ESCO.0722.00149.0001;ESCO.0722.00149.0001i_00108;117475;119181;1706
ESCO.0722.00149;ESCO.0722.00149.0003;ESCO.0722.00149.0003i_00620;187845;189089;1244
ESCO.0722.00149;ESCO.0722.00149.0031;ESCO.0722.00149.0031i_04140;45609;45770;161
ESCO.0722.00149;ESCO.0722.00149.0031;ESCO.0722.00149.0031i_04172;73625;74497;872
ESCO.0722.00149;ESCO.0722.00149.0035;ESCO.0722.00149.0035i_04396;10942;13623;2681
ESCO.0722.00149;ESCO.0722.00149.0035;ESCO.0722.00149.0035i_04428;45583;46014;431
ESCO.0722.00149;ESCO.0722.00149.0037;ESCO.0722.00149.0037i_04524;15925;16725;800
ESCO.0722.00149;ESCO.0722.00149.0037;ESCO.0722.00149.0037i_04556;42171;43409;1238
ESCO.0722.00149;ESCO.0722.00149.0044;ESCO.0722.00149.0044i_04780;12742;12909;167
ESCO.0722.00149;ESCO.0722.00149.0049;ESCO.0722.00149.0049i_04844;1418;2239;821
ESCO.0722.00149;ESCO.0722.00149.0054;ESCO.0722.00149.0054b_04908;5665;6246;581
ESCO.0722.00149;ESCO.0722.00149.0068;ESCO.0722.00149.0068i_04972;2261;2500;239
ESCO.0722.00149;ESCO.0722.00149.0079;ESCO.0722.00149.0079b_05004;1226;1393;167
ESCO.0722.00149;ESCO.0722.00149.0001;ESCO.0722.00149.0001i_00104;111178;111675;497
ESCO.0722.00149;ESCO.0722.00149.0003;ESCO.0722.00149.0003i_00872;445834;446079;245
ESCO.0722.00149;ESCO.0722.00149.0031;ESCO.0722.00149.0031i_04104;10737;11813;1076
ESCO.0722.00149;ESCO.0722.00149.0031;ESCO.0722.00149.0031i_04136;41565;42644;1079
ESCO.0722.00149;ESCO.0722.00149.0031;ESCO.0722.00149.0031i_04168;70731;70904;173
ESCO.0722.00149;ESCO.0722.00149.0035;ESCO.0722.00149.0035i_04392;3880;4401;521
ESCO.0722.00149;ESCO.0722.00149.0035;ESCO.0722.00149.0035i_04424;42669;42932;263
ESCO.0722.00149;ESCO.0722.00149.0037;ESCO.0722.00149.0037i_04520;8409;12359;3950
ESCO.0722.00149;ESCO.0722.00149.0044;ESCO.0722.00149.0044i_04776;9263;9577;314
ESCO.0722.00149;ESCO.0722.00149.0054;ESCO.0722.00149.0054i_04904;2230;2643;413
ESCO.0722.00149;ESCO.0722.00149.0133;ESCO.0722.00149.0133b_05064;1;231;230
ESCO.0722.00149;ESCO.0722.00149.0001;ESCO.0722.00149.0001i_00105;111731;114865;3134
ESCO.0722.00149;ESCO.0722.00149.0003;ESCO.0722.00149.0003i_00617;183618;186236;2618
ESCO.0722.00149;ESCO.0722.00149.0011;ESCO.0722.00149.0011i_01897;7784;8008;224
ESCO.0722.00149;ESCO.0722.00149.0031;ESCO.0722.00149.0031i_04105;11810;14215;2405
ESCO.0722.00149;ESCO.0722.00149.0031;ESCO.0722.00149.0031i_04137;42644;43600;956
ESCO.0722.00149;ESCO.0722.00149.0031;ESCO.0722.00149.0031i_04169;71036;72094;1058
ESCO.0722.00149;ESCO.0722.00149.0035;ESCO.0722.00149.0035i_04393;4398;4787;389
ESCO.0722.00149;ESCO.0722.00149.0035;ESCO.0722.00149.0035i_04425;43026;43787;761
ESCO.0722.00149;ESCO.0722.00149.0037;ESCO.0722.00149.0037i_04521;12368;13783;1415
ESCO.0722.00149;ESCO.0722.00149.0044;ESCO.0722.00149.0044i_04777;9625;10521;896
ESCO.0722.00149;ESCO.0722.00149.0054;ESCO.0722.00149.0054i_04905;2771;3580;809
ESCO.0722.00149;ESCO.0722.00149.0078;ESCO.0722.00149.0078b_05001;157;1419;1262
ESCO.0722.00149;ESCO.0722.00149.0018;ESCO.0722.00149.0018i_02803;23046;24146;1100
ESCO.0722.00149;ESCO.0722.00149.0031;ESCO.0722.00149.0031i_04115;20416;21804;1388
ESCO.0722.00149;ESCO.0722.00149.0031;ESCO.0722.00149.0031i_04147;52160;53242;1082
ESCO.0722.00149;ESCO.0722.00149.0031;ESCO.0722.00149.0031i_04179;83662;84174;512
ESCO.0722.00149;ESCO.0722.00149.0035;ESCO.0722.00149.0035i_04403;19032;19820;788
ESCO.0722.00149;ESCO.0722.00149.0035;ESCO.0722.00149.0035i_04435;50810;51955;1145
ESCO.0722.00149;ESCO.0722.00149.0037;ESCO.0722.00149.0037i_04531;25040;25702;662
ESCO.0722.00149;ESCO.0722.00149.0037;ESCO.0722.00149.0037i_04563;47855;48079;224
ESCO.0722.00149;ESCO.0722.00149.0039;ESCO.0722.00149.0039i_04659;34032;35435;1403
ESCO.0722.00149;ESCO.0722.00149.0044;ESCO.0722.00149.0044i_04787;17412;18527;1115
ESCO.0722.00149;ESCO.0722.00149.0049;ESCO.0722.00149.0049i_04851;6087;6995;908
ESCO.0722.00149;ESCO.0722.00149.0062;ESCO.0722.00149.0062b_04947;3582;4442;860
ESCO.0722.00149;ESCO.0722.00149.0069;ESCO.0722.00149.0069b_04979;3107;3295;188
ESCO.0722.00149;ESCO.0722.00149.0082;ESCO.0722.00149.0082b_05011;858;1133;275
ESCO.0722.00149;ESCO.0722.00149.0147;ESCO.0722.00149.0147b_05075;1;216;215
ESCO.0722.00149;ESCO.0722.00149.0015;ESCO.0722.00149.0015b_02580;142970;144925;1955
ESCO.0722.00149;ESCO.0722.00149.0018;ESCO.0722.00149.0018i_02804;24100;24684;584
ESCO.0722.00149;ESCO.0722.00149.0031;ESCO.0722.00149.0031i_04116;21809;22306;497
ESCO.0722.00149;ESCO.0722.00149.0031;ESCO.0722.00149.0031i_04148;53603;53815;212
ESCO.0722.00149;ESCO.0722.00149.0031;ESCO.0722.00149.0031i_04180;84452;88756;4304
ESCO.0722.00149;ESCO.0722.00149.0035;ESCO.0722.00149.0035i_04404;19832;20092;260
ESCO.0722.00149;ESCO.0722.00149.0035;ESCO.0722.00149.0035i_04436;52361;52738;377
ESCO.0722.00149;ESCO.0722.00149.0037;ESCO.0722.00149.0037i_04532;25713;26894;1181
ESCO.0722.00149;ESCO.0722.00149.0037;ESCO.0722.00149.0037i_04564;48134;48337;203
ESCO.0722.00149;ESCO.0722.00149.0039;ESCO.0722.00149.0039b_04660;35464;36096;632
ESCO.0722.00149;ESCO.0722.00149.0049;ESCO.0722.00149.0049i_04852;7172;7687;515
ESCO.0722.00149;ESCO.0722.00149.0108;ESCO.0722.00149.0108b_05044;3;344;341
ESCO.0722.00149;ESCO.0722.00149.0148;ESCO.0722.00149.0148b_05076;2;157;155
ESCO.0722.00149;ESCO.0722.00149.0031;ESCO.0722.00149.0031b_04085;238;618;380
ESCO.0722.00149;ESCO.0722.00149.0031;ESCO.0722.00149.0031i_04117;22509;23165;656
ESCO.0722.00149;ESCO.0722.00149.0031;ESCO.0722.00149.0031i_04149;53985;55160;1175
ESCO.0722.00149;ESCO.0722.00149.0031;ESCO.0722.00149.0031i_04181;88876;89457;581
ESCO.0722.00149;ESCO.0722.00149.0035;ESCO.0722.00149.0035i_04405;20200;20553;353
ESCO.0722.00149;ESCO.0722.00149.0035;ESCO.0722.00149.0035i_04437;52830;53258;428
ESCO.0722.00149;ESCO.0722.00149.0037;ESCO.0722.00149.0037i_04533;26896;27627;731
ESCO.0722.00149;ESCO.0722.00149.0037;ESCO.0722.00149.0037i_04565;48890;49381;491
ESCO.0722.00149;ESCO.0722.00149.0049;ESCO.0722.00149.0049i_04853;7698;8144;446
ESCO.0722.00149;ESCO.0722.00149.0149;ESCO.0722.00149.0149b_05077;1;210;209
ESCO.0722.00149;ESCO.0722.00149.0198;ESCO.0722.00149.0198b_05109;2;88;86
ESCO.0722.00149;ESCO.0722.00149.0010;ESCO.0722.00149.0010b_01602;3;113;110
ESCO.0722.00149;ESCO.0722.00149.0031;ESCO.0722.00149.0031i_04130;36050;36505;455
ESCO.0722.00149;ESCO.0722.00149.0031;ESCO.0722.00149.0031i_04162;64069;64947;878
ESCO.0722.00149;ESCO.0722.00149.0035;ESCO.0722.00149.0035i_04418;31424;32050;626
ESCO.0722.00149;ESCO.0722.00149.0037;ESCO.0722.00149.0037i_04514;4092;4484;392
ESCO.0722.00149;ESCO.0722.00149.0037;ESCO.0722.00149.0037i_04546;35468;36412;944
ESCO.0722.00149;ESCO.0722.00149.0044;ESCO.0722.00149.0044i_04770;7332;7607;275
ESCO.0722.00149;ESCO.0722.00149.0065;ESCO.0722.00149.0065b_04962;3684;4001;317
ESCO.0722.00149;ESCO.0722.00149.0018;ESCO.0722.00149.0018i_02787;13395;13526;131
ESCO.0722.00149;ESCO.0722.00149.0031;ESCO.0722.00149.0031i_04099;7685;8110;425
ESCO.0722.00149;ESCO.0722.00149.0031;ESCO.0722.00149.0031i_04131;36528;37685;1157
ESCO.0722.00149;ESCO.0722.00149.0031;ESCO.0722.00149.0031i_04163;65026;65547;521
ESCO.0722.00149;ESCO.0722.00149.0035;ESCO.0722.00149.0035i_04419;32423;34879;2456
ESCO.0722.00149;ESCO.0722.00149.0037;ESCO.0722.00149.0037i_04515;4509;5258;749
ESCO.0722.00149;ESCO.0722.00149.0037;ESCO.0722.00149.0037i_04547;36511;37110;599
ESCO.0722.00149;ESCO.0722.00149.0044;ESCO.0722.00149.0044i_04771;7748;7945;197
ESCO.0722.00149;ESCO.0722.00149.0066;ESCO.0722.00149.0066b_04963;192;2249;2057
ESCO.0722.00149;ESCO.0722.00149.0075;ESCO.0722.00149.0075b_04995;436;1542;1106
ESCO.0722.00149;ESCO.0722.00149.0125;ESCO.0722.00149.0125b_05059;37;246;209
ESCO.0722.00149;ESCO.0722.00149.0011;ESCO.0722.00149.0011i_01924;29060;29548;488
ESCO.0722.00149;ESCO.0722.00149.0031;ESCO.0722.00149.0031i_04132;37685;38266;581
ESCO.0722.00149;ESCO.0722.00149.0031;ESCO.0722.00149.0031i_04164;65817;67049;1232
ESCO.0722.00149;ESCO.0722.00149.0035;ESCO.0722.00149.0035b_04388;56;694;638
ESCO.0722.00149;ESCO.0722.00149.0035;ESCO.0722.00149.0035i_04420;35987;37075;1088
ESCO.0722.00149;ESCO.0722.00149.0037;ESCO.0722.00149.0037i_04516;5406;5945;539
ESCO.0722.00149;ESCO.0722.00149.0037;ESCO.0722.00149.0037i_04548;37164;37520;356
ESCO.0722.00149;ESCO.0722.00149.0044;ESCO.0722.00149.0044i_04772;8015;8302;287
ESCO.0722.00149;ESCO.0722.00149.0066;ESCO.0722.00149.0066b_04964;2264;3199;935
ESCO.0722.00149;ESCO.0722.00149.0076;ESCO.0722.00149.0076b_04996;70;570;500
ESCO.0722.00149;ESCO.0722.00149.0095;ESCO.0722.00149.0095b_05028;78;581;503
ESCO.0722.00149;ESCO.0722.00149.0126;ESCO.0722.00149.0126b_05060;38;241;203
ESCO.0722.00149;ESCO.0722.00149.0001;ESCO.0722.00149.0001i_00109;119395;120372;977
ESCO.0722.00149;ESCO.0722.00149.0003;ESCO.0722.00149.0003i_00621;189090;189947;857
ESCO.0722.00149;ESCO.0722.00149.0031;ESCO.0722.00149.0031i_04141;45767;46405;638
ESCO.0722.00149;ESCO.0722.00149.0031;ESCO.0722.00149.0031i_04173;74892;76676;1784
ESCO.0722.00149;ESCO.0722.00149.0035;ESCO.0722.00149.0035i_04397;13632;14582;950
ESCO.0722.00149;ESCO.0722.00149.0035;ESCO.0722.00149.0035i_04429;46007;46264;257
ESCO.0722.00149;ESCO.0722.00149.0037;ESCO.0722.00149.0037i_04525;17310;17462;152
ESCO.0722.00149;ESCO.0722.00149.0044;ESCO.0722.00149.0044i_04781;12932;14251;1319
ESCO.0722.00149;ESCO.0722.00149.0068;ESCO.0722.00149.0068i_04973;2563;2874;311
ESCO.0722.00149;ESCO.0722.00149.0001;ESCO.0722.00149.0001i_00174;194908;196215;1307
ESCO.0722.00149;ESCO.0722.00149.0003;ESCO.0722.00149.0003i_00622;190036;190179;143
ESCO.0722.00149;ESCO.0722.00149.0031;ESCO.0722.00149.0031i_04110;17077;17601;524
ESCO.0722.00149;ESCO.0722.00149.0031;ESCO.0722.00149.0031i_04142;46428;47069;641
ESCO.0722.00149;ESCO.0722.00149.0031;ESCO.0722.00149.0031i_04174;76856;77728;872
ESCO.0722.00149;ESCO.0722.00149.0035;ESCO.0722.00149.0035i_04398;14592;15449;857
ESCO.0722.00149;ESCO.0722.00149.0035;ESCO.0722.00149.0035i_04430;46251;46439;188
ESCO.0722.00149;ESCO.0722.00149.0037;ESCO.0722.00149.0037i_04526;17485;17970;485
ESCO.0722.00149;ESCO.0722.00149.0037;ESCO.0722.00149.0037i_04558;45602;46207;605
ESCO.0722.00149;ESCO.0722.00149.0044;ESCO.0722.00149.0044i_04782;14264;14467;203
ESCO.0722.00149;ESCO.0722.00149.0062;ESCO.0722.00149.0062b_04942;2;379;377
ESCO.0722.00149;ESCO.0722.00149.0068;ESCO.0722.00149.0068i_04974;2871;3065;194
ESCO.0722.00149;ESCO.0722.00149.0140;ESCO.0722.00149.0140b_05070;2;169;167
ESCO.0722.00149;ESCO.0722.00149.0182;ESCO.0722.00149.0182b_05102;2;109;107
ESCO.0722.00149;ESCO.0722.00149.0031;ESCO.0722.00149.0031i_04111;17614;18024;410
ESCO.0722.00149;ESCO.0722.00149.0031;ESCO.0722.00149.0031i_04143;47069;47707;638
ESCO.0722.00149;ESCO.0722.00149.0031;ESCO.0722.00149.0031i_04175;77757;80945;3188
ESCO.0722.00149;ESCO.0722.00149.0035;ESCO.0722.00149.0035i_04399;15463;15945;482
ESCO.0722.00149;ESCO.0722.00149.0035;ESCO.0722.00149.0035i_04431;46472;46723;251
ESCO.0722.00149;ESCO.0722.00149.0037;ESCO.0722.00149.0037i_04527;17967;18704;737
ESCO.0722.00149;ESCO.0722.00149.0037;ESCO.0722.00149.0037i_04559;46424;46705;281
ESCO.0722.00149;ESCO.0722.00149.0044;ESCO.0722.00149.0044i_04783;14531;15736;1205
ESCO.0722.00149;ESCO.0722.00149.0062;ESCO.0722.00149.0062i_04943;372;1052;680
ESCO.0722.00149;ESCO.0722.00149.0068;ESCO.0722.00149.0068b_04975;3120;3569;449
ESCO.0722.00149;ESCO.0722.00149.0141;ESCO.0722.00149.0141b_05071;3;155;152
ESCO.0722.00149;ESCO.0722.00149.0186;ESCO.0722.00149.0186b_05103;3;107;104
ESCO.0722.00149;ESCO.0722.00149.0001;ESCO.0722.00149.0001i_00123;129879;130676;797
ESCO.0722.00149;ESCO.0722.00149.0031;ESCO.0722.00149.0031i_04091;3376;3579;203
ESCO.0722.00149;ESCO.0722.00149.0031;ESCO.0722.00149.0031i_04155;58503;58760;257
ESCO.0722.00149;ESCO.0722.00149.0031;ESCO.0722.00149.0031i_04187;96615;96956;341
ESCO.0722.00149;ESCO.0722.00149.0035;ESCO.0722.00149.0035i_04411;25274;26128;854
ESCO.0722.00149;ESCO.0722.00149.0035;ESCO.0722.00149.0035i_04443;57015;57272;257
ESCO.0722.00149;ESCO.0722.00149.0037;ESCO.0722.00149.0037i_04539;30300;30836;536
ESCO.0722.00149;ESCO.0722.00149.0044;ESCO.0722.00149.0044b_04763;136;1539;1403
ESCO.0722.00149;ESCO.0722.00149.0065;ESCO.0722.00149.0065b_04955;113;262;149
ESCO.0722.00149;ESCO.0722.00149.0072;ESCO.0722.00149.0072i_04987;1308;1877;569
ESCO.0722.00149;ESCO.0722.00149.0089;ESCO.0722.00149.0089b_05019;3;140;137
ESCO.0722.00149;ESCO.0722.00149.0155;ESCO.0722.00149.0155b_05083;3;149;146
ESCO.0722.00149;ESCO.0722.00149.0001;ESCO.0722.00149.0001i_00124;132244;136959;4715
ESCO.0722.00149;ESCO.0722.00149.0001;ESCO.0722.00149.0001i_00188;214375;215058;683
ESCO.0722.00149;ESCO.0722.00149.0031;ESCO.0722.00149.0031i_04092;3641;4498;857
ESCO.0722.00149;ESCO.0722.00149.0031;ESCO.0722.00149.0031i_04124;30726;31538;812
ESCO.0722.00149;ESCO.0722.00149.0031;ESCO.0722.00149.0031i_04156;58768;59232;464
ESCO.0722.00149;ESCO.0722.00149.0031;ESCO.0722.00149.0031i_04188;96956;98326;1370
ESCO.0722.00149;ESCO.0722.00149.0035;ESCO.0722.00149.0035i_04412;26137;26910;773
ESCO.0722.00149;ESCO.0722.00149.0035;ESCO.0722.00149.0035i_04444;57502;58293;791
ESCO.0722.00149;ESCO.0722.00149.0037;ESCO.0722.00149.0037b_04508;34;132;98
ESCO.0722.00149;ESCO.0722.00149.0037;ESCO.0722.00149.0037i_04540;30904;31341;437
ESCO.0722.00149;ESCO.0722.00149.0044;ESCO.0722.00149.0044i_04764;1572;2276;704
ESCO.0722.00149;ESCO.0722.00149.0072;ESCO.0722.00149.0072b_04988;1877;2377;500
ESCO.0722.00149;ESCO.0722.00149.0089;ESCO.0722.00149.0089b_05020;137;631;494
ESCO.0722.00149;ESCO.0722.00149.0001;ESCO.0722.00149.0001i_00125;136956;139187;2231
ESCO.0722.00149;ESCO.0722.00149.0031;ESCO.0722.00149.0031i_04093;4514;4822;308
ESCO.0722.00149;ESCO.0722.00149.0031;ESCO.0722.00149.0031i_04125;31554;31955;401
ESCO.0722.00149;ESCO.0722.00149.0031;ESCO.0722.00149.0031i_04157;59403;59678;275
ESCO.0722.00149;ESCO.0722.00149.0031;ESCO.0722.00149.0031i_04189;98323;99411;1088
ESCO.0722.00149;ESCO.0722.00149.0035;ESCO.0722.00149.0035i_04413;27319;28482;1163
ESCO.0722.00149;ESCO.0722.00149.0035;ESCO.0722.00149.0035b_04445;58344;58544;200
ESCO.0722.00149;ESCO.0722.00149.0037;ESCO.0722.00149.0037i_04509;326;760;434
ESCO.0722.00149;ESCO.0722.00149.0037;ESCO.0722.00149.0037i_04541;31386;31682;296
ESCO.0722.00149;ESCO.0722.00149.0044;ESCO.0722.00149.0044i_04765;2363;2683;320
ESCO.0722.00149;ESCO.0722.00149.0065;ESCO.0722.00149.0065i_04957;1299;1724;425
ESCO.0722.00149;ESCO.0722.00149.0090;ESCO.0722.00149.0090b_05021;234;722;488
ESCO.0722.00149;ESCO.0722.00149.0157;ESCO.0722.00149.0157b_05085;2;205;203
ESCO.0722.00151;ESCO.0722.00151.0015;ESCO.0722.00151.0015i_03041;82524;83189;665
ESCO.0722.00151;ESCO.0722.00151.0015;ESCO.0722.00151.0015i_03073;110047;111555;1508
ESCO.0722.00151;ESCO.0722.00151.0030;ESCO.0722.00151.0030i_04257;12496;14115;1619
ESCO.0722.00151;ESCO.0722.00151.0043;ESCO.0722.00151.0043i_04641;8783;9082;299
ESCO.0722.00151;ESCO.0722.00151.0058;ESCO.0722.00151.0058b_04769;1;762;761
ESCO.0722.00151;ESCO.0722.00151.0100;ESCO.0722.00151.0100b_04929;3;1463;1460
ESCO.0722.00151;ESCO.0722.00151.0145;ESCO.0722.00151.0145b_04993;23;565;542
ESCO.0722.00151;ESCO.0722.00151.0209;ESCO.0722.00151.0209b_05057;3;86;83
ESCO.0722.00151;ESCO.0722.00151.0241;ESCO.0722.00151.0241b_05089;2;238;236
ESCO.0722.00151;ESCO.0722.00151.0274;ESCO.0722.00151.0274b_05121;2;208;206
ESCO.0722.00151;ESCO.0722.00151.0015;ESCO.0722.00151.0015i_03042;83186;83944;758
ESCO.0722.00151;ESCO.0722.00151.0015;ESCO.0722.00151.0015i_03074;111587;111964;377
ESCO.0722.00151;ESCO.0722.00151.0022;ESCO.0722.00151.0022i_03874;8095;8367;272
ESCO.0722.00151;ESCO.0722.00151.0030;ESCO.0722.00151.0030i_04258;14176;15207;1031
ESCO.0722.00151;ESCO.0722.00151.0074;ESCO.0722.00151.0074i_04866;1162;3843;2681
ESCO.0722.00151;ESCO.0722.00151.0120;ESCO.0722.00151.0120b_04962;841;996;155
ESCO.0722.00151;ESCO.0722.00151.0242;ESCO.0722.00151.0242b_05090;1;87;86
ESCO.0722.00151;ESCO.0722.00151.0275;ESCO.0722.00151.0275b_05122;1;207;206
ESCO.0722.00151;ESCO.0722.00151.0001;ESCO.0722.00151.0001i_00209;229061;229348;287
ESCO.0722.00151;ESCO.0722.00151.0004;ESCO.0722.00151.0004i_00625;89581;89991;410
ESCO.0722.00151;ESCO.0722.00151.0015;ESCO.0722.00151.0015i_03057;93343;94845;1502
ESCO.0722.00151;ESCO.0722.00151.0028;ESCO.0722.00151.0028b_04177;2;235;233
ESCO.0722.00151;ESCO.0722.00151.0063;ESCO.0722.00151.0063i_04817;4464;4790;326
ESCO.0722.00151;ESCO.0722.00151.0067;ESCO.0722.00151.0067b_04849;4826;5122;296
ESCO.0722.00151;ESCO.0722.00151.0079;ESCO.0722.00151.0079b_04881;1280;1456;176
ESCO.0722.00151;ESCO.0722.00151.0094;ESCO.0722.00151.0094b_04913;369;851;482
ESCO.0722.00151;ESCO.0722.00151.0110;ESCO.0722.00151.0110b_04945;3;1178;1175
ESCO.0722.00151;ESCO.0722.00151.0161;ESCO.0722.00151.0161b_05009;369;443;74
ESCO.0722.00151;ESCO.0722.00151.0299;ESCO.0722.00151.0299b_05137;3;113;110
ESCO.0722.00151;ESCO.0722.00151.0007;ESCO.0722.00151.0007i_01682;271135;271719;584
ESCO.0722.00151;ESCO.0722.00151.0015;ESCO.0722.00151.0015i_03026;69693;70568;875
ESCO.0722.00151;ESCO.0722.00151.0015;ESCO.0722.00151.0015i_03058;94856;95224;368
ESCO.0722.00151;ESCO.0722.00151.0034;ESCO.0722.00151.0034i_04466;29144;29782;638
ESCO.0722.00151;ESCO.0722.00151.0063;ESCO.0722.00151.0063i_04818;4787;5287;500
ESCO.0722.00151;ESCO.0722.00151.0080;ESCO.0722.00151.0080b_04882;1;1074;1073
ESCO.0722.00151;ESCO.0722.00151.0094;ESCO.0722.00151.0094b_04914;1212;1754;542
ESCO.0722.00151;ESCO.0722.00151.0162;ESCO.0722.00151.0162b_05010;1;438;437
ESCO.0722.00151;ESCO.0722.00151.0226;ESCO.0722.00151.0226b_05074;2;256;254
ESCO.0722.00151;ESCO.0722.00151.0259;ESCO.0722.00151.0259b_05106;1;222;221
ESCO.0722.00151;ESCO.0722.00151.0007;ESCO.0722.00151.0007i_01683;271719;273362;1643
ESCO.0722.00151;ESCO.0722.00151.0009;ESCO.0722.00151.0009i_02067;44479;44640;161
ESCO.0722.00151;ESCO.0722.00151.0015;ESCO.0722.00151.0015i_03027;70561;71931;1370
ESCO.0722.00151;ESCO.0722.00151.0015;ESCO.0722.00151.0015i_03059;95224;95634;410
ESCO.0722.00151;ESCO.0722.00151.0018;ESCO.0722.00151.0018i_03379;1741;2445;704
ESCO.0722.00151;ESCO.0722.00151.0034;ESCO.0722.00151.0034i_04467;29770;29964;194
ESCO.0722.00151;ESCO.0722.00151.0063;ESCO.0722.00151.0063i_04819;5284;5655;371
ESCO.0722.00151;ESCO.0722.00151.0080;ESCO.0722.00151.0080b_04883;1055;1468;413
ESCO.0722.00151;ESCO.0722.00151.0163;ESCO.0722.00151.0163b_05011;2;436;434
ESCO.0722.00151;ESCO.0722.00151.0260;ESCO.0722.00151.0260b_05107;3;224;221
ESCO.0722.00151;ESCO.0722.00151.0004;ESCO.0722.00151.0004i_00614;81515;81679;164
ESCO.0722.00151;ESCO.0722.00151.0007;ESCO.0722.00151.0007i_01638;225420;225932;512
ESCO.0722.00151;ESCO.0722.00151.0014;ESCO.0722.00151.0014i_02918;19305;19700;395
ESCO.0722.00151;ESCO.0722.00151.0015;ESCO.0722.00151.0015i_03046;85831;86403;572
ESCO.0722.00151;ESCO.0722.00151.0015;ESCO.0722.00151.0015i_03078;113478;114020;542
ESCO.0722.00151;ESCO.0722.00151.0018;ESCO.0722.00151.0018i_03398;21001;26511;5510
ESCO.0722.00151;ESCO.0722.00151.0027;ESCO.0722.00151.0027i_04134;51193;51891;698
ESCO.0722.00151;ESCO.0722.00151.0028;ESCO.0722.00151.0028i_04198;13487;13759;272
ESCO.0722.00151;ESCO.0722.00151.0090;ESCO.0722.00151.0090b_04902;3;827;824
ESCO.0722.00151;ESCO.0722.00151.0007;ESCO.0722.00151.0007i_01639;225890;226159;269
ESCO.0722.00151;ESCO.0722.00151.0014;ESCO.0722.00151.0014i_02919;19737;20774;1037
ESCO.0722.00151;ESCO.0722.00151.0015;ESCO.0722.00151.0015i_03047;86414;86902;488
ESCO.0722.00151;ESCO.0722.00151.0015;ESCO.0722.00151.0015i_03079;114510;115058;548
ESCO.0722.00151;ESCO.0722.00151.0018;ESCO.0722.00151.0018i_03399;26508;27551;1043
ESCO.0722.00151;ESCO.0722.00151.0019;ESCO.0722.00151.0019i_03623;118153;118314;161
ESCO.0722.00151;ESCO.0722.00151.0028;ESCO.0722.00151.0028i_04199;13793;14254;461
ESCO.0722.00151;ESCO.0722.00151.0151;ESCO.0722.00151.0151b_04999;2;490;488
ESCO.0722.00151;ESCO.0722.00151.0213;ESCO.0722.00151.0213b_05063;2;289;287
ESCO.0722.00151;ESCO.0722.00151.0284;ESCO.0722.00151.0284b_05127;1;72;71
ESCO.0722.00151;ESCO.0722.00151.0004;ESCO.0722.00151.0004i_00616;82673;84334;1661
ESCO.0722.00151;ESCO.0722.00151.0014;ESCO.0722.00151.0014i_02920;20859;21020;161
ESCO.0722.00151;ESCO.0722.00151.0018;ESCO.0722.00151.0018i_03400;27563;29446;1883
ESCO.0722.00151;ESCO.0722.00151.0019;ESCO.0722.00151.0019i_03624;118351;118899;548
ESCO.0722.00151;ESCO.0722.00151.0028;ESCO.0722.00151.0028i_04200;14260;14835;575
ESCO.0722.00151;ESCO.0722.00151.0249;ESCO.0722.00151.0249b_05096;2;229;227
ESCO.0722.00151;ESCO.0722.00151.0015;ESCO.0722.00151.0015i_03033;76498;76770;272
ESCO.0722.00151;ESCO.0722.00151.0015;ESCO.0722.00151.0015i_03065;100649;102868;2219
ESCO.0722.00151;ESCO.0722.00151.0030;ESCO.0722.00151.0030i_04249;1999;2646;647
ESCO.0722.00151;ESCO.0722.00151.0056;ESCO.0722.00151.0056b_04761;6534;7112;578
ESCO.0722.00151;ESCO.0722.00151.0082;ESCO.0722.00151.0082b_04889;2;2929;2927
ESCO.0722.00151;ESCO.0722.00151.0097;ESCO.0722.00151.0097b_04921;2;280;278
ESCO.0722.00151;ESCO.0722.00151.0266;ESCO.0722.00151.0266b_05113;1;192;191
ESCO.0722.00151;ESCO.0722.00151.0317;ESCO.0722.00151.0317b_05145;3;83;80
ESCO.0722.00151;ESCO.0722.00151.0004;ESCO.0722.00151.0004i_00634;94016;94195;179
ESCO.0722.00151;ESCO.0722.00151.0015;ESCO.0722.00151.0015i_03034;76839;77564;725
ESCO.0722.00151;ESCO.0722.00151.0015;ESCO.0722.00151.0015i_03066;102861;103433;572
ESCO.0722.00151;ESCO.0722.00151.0025;ESCO.0722.00151.0025i_03962;1098;1637;539
ESCO.0722.00151;ESCO.0722.00151.0030;ESCO.0722.00151.0030i_04250;2722;3324;602
ESCO.0722.00151;ESCO.0722.00151.0138;ESCO.0722.00151.0138b_04986;35;616;581
ESCO.0722.00151;ESCO.0722.00151.0234;ESCO.0722.00151.0234b_05082;3;242;239
ESCO.0722.00151;ESCO.0722.00151.0267;ESCO.0722.00151.0267b_05114;1;213;212
ESCO.0722.00151;ESCO.0722.00151.0015;ESCO.0722.00151.0015i_03035;77566;78120;554
ESCO.0722.00151;ESCO.0722.00151.0015;ESCO.0722.00151.0015i_03067;103423;104562;1139
ESCO.0722.00151;ESCO.0722.00151.0018;ESCO.0722.00151.0018i_03387;10335;10955;620
ESCO.0722.00151;ESCO.0722.00151.0025;ESCO.0722.00151.0025i_03963;1745;2224;479
ESCO.0722.00151;ESCO.0722.00151.0030;ESCO.0722.00151.0030i_04251;3392;3739;347
ESCO.0722.00151;ESCO.0722.00151.0202;ESCO.0722.00151.0202b_05051;3;311;308
ESCO.0722.00151;ESCO.0722.00151.0235;ESCO.0722.00151.0235b_05083;2;241;239
ESCO.0722.00151;ESCO.0722.00151.0268;ESCO.0722.00151.0268b_05115;2;214;212
ESCO.0722.00151;ESCO.0722.00151.0015;ESCO.0722.00151.0015i_03040;82139;82387;248
ESCO.0722.00151;ESCO.0722.00151.0015;ESCO.0722.00151.0015i_03072;109706;110044;338
ESCO.0722.00151;ESCO.0722.00151.0030;ESCO.0722.00151.0030i_04256;10921;12429;1508
ESCO.0722.00151;ESCO.0722.00151.0054;ESCO.0722.00151.0054b_04736;2;775;773
ESCO.0722.00151;ESCO.0722.00151.0074;ESCO.0722.00151.0074b_04864;2;232;230
ESCO.0722.00151;ESCO.0722.00151.0175;ESCO.0722.00151.0175b_05024;3;392;389
ESCO.0722.00151;ESCO.0722.00151.0208;ESCO.0722.00151.0208b_05056;155;304;149
ESCO.0722.00151;ESCO.0722.00151.0240;ESCO.0722.00151.0240b_05088;2;238;236
ESCO.0722.00151;ESCO.0722.00151.0273;ESCO.0722.00151.0273b_05120;3;209;206
ESCO.0722.00151;ESCO.0722.00151.0004;ESCO.0722.00151.0004i_00823;290098;290739;641
ESCO.0722.00151;ESCO.0722.00151.0015;ESCO.0722.00151.0015i_03031;74925;75173;248
ESCO.0722.00151;ESCO.0722.00151.0015;ESCO.0722.00151.0015i_03063;99430;99561;131
ESCO.0722.00151;ESCO.0722.00151.0019;ESCO.0722.00151.0019i_03639;133147;133449;302
ESCO.0722.00151;ESCO.0722.00151.0024;ESCO.0722.00151.0024b_03959;17082;17573;491
ESCO.0722.00151;ESCO.0722.00151.0027;ESCO.0722.00151.0027i_04087;11628;12119;491
ESCO.0722.00151;ESCO.0722.00151.0030;ESCO.0722.00151.0030i_04247;1096;1470;374
ESCO.0722.00151;ESCO.0722.00151.0198;ESCO.0722.00151.0198b_05047;3;326;323
ESCO.0722.00151;ESCO.0722.00151.0265;ESCO.0722.00151.0265b_05111;3;104;101
ESCO.0722.00151;ESCO.0722.00151.0004;ESCO.0722.00151.0004i_00824;290749;291279;530
ESCO.0722.00151;ESCO.0722.00151.0015;ESCO.0722.00151.0015i_03032;75273;76511;1238
ESCO.0722.00151;ESCO.0722.00151.0015;ESCO.0722.00151.0015i_03064;99558;100652;1094
ESCO.0722.00151;ESCO.0722.00151.0030;ESCO.0722.00151.0030i_04248;1549;1914;365
ESCO.0722.00151;ESCO.0722.00151.0056;ESCO.0722.00151.0056i_04760;5646;6473;827
ESCO.0722.00151;ESCO.0722.00151.0265;ESCO.0722.00151.0265b_05112;101;217;116
ESCO.0722.00151;ESCO.0722.00151.0004;ESCO.0722.00151.0004i_00619;85403;85696;293
ESCO.0722.00151;ESCO.0722.00151.0014;ESCO.0722.00151.0014b_02891;3;137;134
ESCO.0722.00151;ESCO.0722.00151.0015;ESCO.0722.00151.0015i_03051;90368;90715;347
ESCO.0722.00151;ESCO.0722.00151.0018;ESCO.0722.00151.0018i_03403;32717;33688;971
ESCO.0722.00151;ESCO.0722.00151.0026;ESCO.0722.00151.0026b_04075;2053;2868;815
ESCO.0722.00151;ESCO.0722.00151.0027;ESCO.0722.00151.0027i_04139;53874;54023;149
ESCO.0722.00151;ESCO.0722.00151.0054;ESCO.0722.00151.0054i_04747;5148;5669;521
ESCO.0722.00151;ESCO.0722.00151.0107;ESCO.0722.00151.0107b_04939;3;1199;1196
ESCO.0722.00151;ESCO.0722.00151.0004;ESCO.0722.00151.0004i_00620;85693;86031;338
ESCO.0722.00151;ESCO.0722.00151.0015;ESCO.0722.00151.0015i_03052;90715;90957;242
ESCO.0722.00151;ESCO.0722.00151.0027;ESCO.0722.00151.0027i_04140;54027;55043;1016
ESCO.0722.00151;ESCO.0722.00151.0128;ESCO.0722.00151.0128b_04972;1;99;98
ESCO.0722.00151;ESCO.0722.00151.0156;ESCO.0722.00151.0156b_05004;2;478;476
ESCO.0722.00151;ESCO.0722.00151.0253;ESCO.0722.00151.0253b_05100;2;226;224
ESCO.0722.00151;ESCO.0722.00151.0291;ESCO.0722.00151.0291b_05132;3;128;125
ESCO.0722.00151;ESCO.0722.00151.0004;ESCO.0722.00151.0004i_00621;86028;87203;1175
ESCO.0722.00151;ESCO.0722.00151.0014;ESCO.0722.00151.0014i_02893;621;743;122
ESCO.0722.00151;ESCO.0722.00151.0015;ESCO.0722.00151.0015i_03053;90992;91378;386
ESCO.0722.00151;ESCO.0722.00151.0027;ESCO.0722.00151.0027i_04141;55027;55311;284
ESCO.0722.00151;ESCO.0722.00151.0077;ESCO.0722.00151.0077b_04877;867;1202;335
ESCO.0722.00151;ESCO.0722.00151.0093;ESCO.0722.00151.0093b_04909;2;169;167
ESCO.0722.00151;ESCO.0722.00151.0157;ESCO.0722.00151.0157b_05005;3;473;470
ESCO.0722.00151;ESCO.0722.00151.0220;ESCO.0722.00151.0220b_05069;2;265;263
ESCO.0722.00151;ESCO.0722.00151.0254;ESCO.0722.00151.0254b_05101;2;223;221
ESCO.0722.00151;ESCO.0722.00151.0004;ESCO.0722.00151.0004i_00585;53403;53867;464
ESCO.0722.00151;ESCO.0722.00151.0004;ESCO.0722.00151.0004i_00617;84318;84674;356
ESCO.0722.00151;ESCO.0722.00151.0015;ESCO.0722.00151.0015i_03049;88987;89745;758
ESCO.0722.00151;ESCO.0722.00151.0015;ESCO.0722.00151.0015b_03081;116982;117881;899
ESCO.0722.00151;ESCO.0722.00151.0018;ESCO.0722.00151.0018i_03401;29458;31104;1646
ESCO.0722.00151;ESCO.0722.00151.0054;ESCO.0722.00151.0054i_04745;4155;4460;305
ESCO.0722.00151;ESCO.0722.00151.0058;ESCO.0722.00151.0058b_04777;6105;7043;938
ESCO.0722.00151;ESCO.0722.00151.0250;ESCO.0722.00151.0250b_05097;3;227;224
ESCO.0722.00151;ESCO.0722.00151.0004;ESCO.0722.00151.0004i_00586;53943;55448;1505
ESCO.0722.00151;ESCO.0722.00151.0004;ESCO.0722.00151.0004i_00618;84963;85403;440
ESCO.0722.00151;ESCO.0722.00151.0014;ESCO.0722.00151.0014i_02922;22041;23138;1097
ESCO.0722.00151;ESCO.0722.00151.0015;ESCO.0722.00151.0015i_03050;89836;90183;347
ESCO.0722.00151;ESCO.0722.00151.0018;ESCO.0722.00151.0018i_03402;31126;32340;1214
ESCO.0722.00151;ESCO.0722.00151.0027;ESCO.0722.00151.0027i_04138;53186;53872;686
ESCO.0722.00151;ESCO.0722.00151.0126;ESCO.0722.00151.0126b_04970;3;830;827
ESCO.0722.00151;ESCO.0722.00151.0154;ESCO.0722.00151.0154b_05002;1;480;479
ESCO.0722.00151;ESCO.0722.00151.0183;ESCO.0722.00151.0183b_05034;3;377;374
ESCO.0722.00151;ESCO.0722.00151.0217;ESCO.0722.00151.0217b_05066;2;274;272
ESCO.0722.00151;ESCO.0722.00151.0004;ESCO.0722.00151.0004i_00628;92285;92584;299
ESCO.0722.00151;ESCO.0722.00151.0015;ESCO.0722.00151.0015i_03028;71928;73628;1700
ESCO.0722.00151;ESCO.0722.00151.0034;ESCO.0722.00151.0034i_04468;29988;30290;302
ESCO.0722.00151;ESCO.0722.00151.0043;ESCO.0722.00151.0043b_04628;69;2324;2255
ESCO.0722.00151;ESCO.0722.00151.0063;ESCO.0722.00151.0063b_04820;5649;6206;557
ESCO.0722.00151;ESCO.0722.00151.0081;ESCO.0722.00151.0081b_04884;1;129;128
ESCO.0722.00151;ESCO.0722.00151.0261;ESCO.0722.00151.0261b_05108;3;221;218
ESCO.0722.00151;ESCO.0722.00151.0003;ESCO.0722.00151.0003b_00533;189849;190181;332
ESCO.0722.00151;ESCO.0722.00151.0015;ESCO.0722.00151.0015i_03029;73621;74331;710
ESCO.0722.00151;ESCO.0722.00151.0015;ESCO.0722.00151.0015i_03061;98489;98866;377
ESCO.0722.00151;ESCO.0722.00151.0018;ESCO.0722.00151.0018i_03381;2812;3000;188
ESCO.0722.00151;ESCO.0722.00151.0027;ESCO.0722.00151.0027i_04085;9862;11046;1184
ESCO.0722.00151;ESCO.0722.00151.0030;ESCO.0722.00151.0030b_04245;29;331;302
ESCO.0722.00151;ESCO.0722.00151.0034;ESCO.0722.00151.0034i_04469;30329;30778;449
ESCO.0722.00151;ESCO.0722.00151.0229;ESCO.0722.00151.0229b_05077;2;253;251
ESCO.0722.00151;ESCO.0722.00151.0263;ESCO.0722.00151.0263b_05109;2;205;203
ESCO.0722.00151;ESCO.0722.00151.0307;ESCO.0722.00151.0307b_05141;2;94;92
ESCO.0722.00151;ESCO.0722.00151.0004;ESCO.0722.00151.0004i_00630;92893;93045;152
ESCO.0722.00151;ESCO.0722.00151.0015;ESCO.0722.00151.0015i_03062;99186;99335;149
ESCO.0722.00151;ESCO.0722.00151.0018;ESCO.0722.00151.0018i_03382;2997;3461;464
ESCO.0722.00151;ESCO.0722.00151.0027;ESCO.0722.00151.0027i_04086;11033;11539;506
ESCO.0722.00151;ESCO.0722.00151.0030;ESCO.0722.00151.0030i_04246;735;1103;368
ESCO.0722.00151;ESCO.0722.00151.0056;ESCO.0722.00151.0056i_04758;3102;3725;623
ESCO.0722.00151;ESCO.0722.00151.0169;ESCO.0722.00151.0169b_05014;2;298;296
ESCO.0722.00151;ESCO.0722.00151.0197;ESCO.0722.00151.0197b_05046;53;325;272
ESCO.0722.00151;ESCO.0722.00151.0015;ESCO.0722.00151.0015i_03043;83956;84678;722
ESCO.0722.00151;ESCO.0722.00151.0015;ESCO.0722.00151.0015i_03075;112106;112219;113
ESCO.0722.00151;ESCO.0722.00151.0043;ESCO.0722.00151.0043i_04643;10620;11807;1187
ESCO.0722.00151;ESCO.0722.00151.0074;ESCO.0722.00151.0074b_04867;3936;4376;440
ESCO.0722.00151;ESCO.0722.00151.0147;ESCO.0722.00151.0147b_04995;2;82;80
ESCO.0722.00151;ESCO.0722.00151.0210;ESCO.0722.00151.0210b_05059;3;161;158
ESCO.0722.00151;ESCO.0722.00151.0242;ESCO.0722.00151.0242b_05091;144;236;92
ESCO.0722.00151;ESCO.0722.00151.0276;ESCO.0722.00151.0276b_05123;2;205;203
ESCO.0722.00151;ESCO.0722.00151.0015;ESCO.0722.00151.0015i_03044;84657;85292;635
ESCO.0722.00151;ESCO.0722.00151.0015;ESCO.0722.00151.0015i_03076;112316;112957;641
ESCO.0722.00151;ESCO.0722.00151.0018;ESCO.0722.00151.0018i_03396;19641;20330;689
ESCO.0722.00151;ESCO.0722.00151.0028;ESCO.0722.00151.0028i_04196;12312;12878;566
ESCO.0722.00151;ESCO.0722.00151.0043;ESCO.0722.00151.0043b_04644;11807;12172;365
ESCO.0722.00151;ESCO.0722.00151.0089;ESCO.0722.00151.0089b_04900;122;322;200
ESCO.0722.00151;ESCO.0722.00151.0122;ESCO.0722.00151.0122b_04964;78;701;623
ESCO.0722.00151;ESCO.0722.00151.0148;ESCO.0722.00151.0148b_04996;1;534;533
ESCO.0722.00151;ESCO.0722.00151.0211;ESCO.0722.00151.0211b_05060;1;126;125
ESCO.0722.00151;ESCO.0722.00151.0243;ESCO.0722.00151.0243b_05092;3;236;233
ESCO.0722.00151;ESCO.0722.00151.0277;ESCO.0722.00151.0277b_05124;2;97;95
ESCO.0722.00151;ESCO.0722.00151.0014;ESCO.0722.00151.0014i_02917;18301;19305;1004
ESCO.0722.00151;ESCO.0722.00151.0015;ESCO.0722.00151.0015i_03045;85298;85831;533
ESCO.0722.00151;ESCO.0722.00151.0015;ESCO.0722.00151.0015i_03077;113158;113424;266
ESCO.0722.00151;ESCO.0722.00151.0028;ESCO.0722.00151.0028i_04197;12878;13450;572
ESCO.0722.00151;ESCO.0722.00151.0178;ESCO.0722.00151.0178b_05029;3;389;386
ESCO.0722.00151;ESCO.0722.00151.0246;ESCO.0722.00151.0246b_05093;3;230;227
ESCO.0722.00151;ESCO.0722.00151.0004;ESCO.0722.00151.0004i_00590;57522;58112;590
ESCO.0722.00151;ESCO.0722.00151.0004;ESCO.0722.00151.0004i_00622;87241;87813;572
ESCO.0722.00151;ESCO.0722.00151.0015;ESCO.0722.00151.0015i_03054;91391;91747;356
ESCO.0722.00151;ESCO.0722.00151.0063;ESCO.0722.00151.0063i_04814;3175;3465;290
ESCO.0722.00151;ESCO.0722.00151.0078;ESCO.0722.00151.0078b_04878;3;1775;1772
ESCO.0722.00151;ESCO.0722.00151.0187;ESCO.0722.00151.0187b_05038;3;92;89
ESCO.0722.00151;ESCO.0722.00151.0255;ESCO.0722.00151.0255b_05102;2;223;221
ESCO.0722.00151;ESCO.0722.00151.0004;ESCO.0722.00151.0004i_00559;28516;28725;209
ESCO.0722.00151;ESCO.0722.00151.0004;ESCO.0722.00151.0004i_00591;58212;58982;770
ESCO.0722.00151;ESCO.0722.00151.0004;ESCO.0722.00151.0004i_00623;87853;89010;1157
ESCO.0722.00151;ESCO.0722.00151.0015;ESCO.0722.00151.0015i_03055;91744;92403;659
ESCO.0722.00151;ESCO.0722.00151.0063;ESCO.0722.00151.0063i_04815;3462;3863;401
ESCO.0722.00151;ESCO.0722.00151.0160;ESCO.0722.00151.0160b_05007;3;458;455
ESCO.0722.00151;ESCO.0722.00151.0256;ESCO.0722.00151.0256b_05103;2;223;221
ESCO.0722.00151;ESCO.0722.00151.0001;ESCO.0722.00151.0001i_00208;228284;229018;734
ESCO.0722.00151;ESCO.0722.00151.0004;ESCO.0722.00151.0004i_00624;89298;89570;272
ESCO.0722.00151;ESCO.0722.00151.0015;ESCO.0722.00151.0015i_03056;92403;93353;950
ESCO.0722.00151;ESCO.0722.00151.0063;ESCO.0722.00151.0063i_04816;3853;4209;356
ESCO.0722.00151;ESCO.0722.00151.0161;ESCO.0722.00151.0161b_05008;2;247;245
ESCO.0722.00151;ESCO.0722.00151.0190;ESCO.0722.00151.0190b_05040;1;348;347
ESCO.0722.00151;ESCO.0722.00151.0257;ESCO.0722.00151.0257b_05104;2;223;221
ESCO.0722.00151;ESCO.0722.00151.0015;ESCO.0722.00151.0015i_03039;81913;82155;242
ESCO.0722.00151;ESCO.0722.00151.0015;ESCO.0722.00151.0015i_03071;108232;109695;1463
ESCO.0722.00151;ESCO.0722.00151.0030;ESCO.0722.00151.0030i_04255;8754;10610;1856
ESCO.0722.00151;ESCO.0722.00151.0099;ESCO.0722.00151.0099b_04927;3;905;902
ESCO.0722.00151;ESCO.0722.00151.0119;ESCO.0722.00151.0119b_04959;2;1027;1025
ESCO.0722.00151;ESCO.0722.00151.0142;ESCO.0722.00151.0142b_04991;3;590;587
ESCO.0722.00151;ESCO.0722.00151.0272;ESCO.0722.00151.0272b_05119;3;209;206
ESCO.0722.00151;ESCO.0722.00151.0015;ESCO.0722.00151.0015i_03036;78136;80145;2009
ESCO.0722.00151;ESCO.0722.00151.0015;ESCO.0722.00151.0015i_03068;104566;105870;1304
ESCO.0722.00151;ESCO.0722.00151.0018;ESCO.0722.00151.0018i_03388;11915;12421;506
ESCO.0722.00151;ESCO.0722.00151.0025;ESCO.0722.00151.0025i_03964;2493;3350;857
ESCO.0722.00151;ESCO.0722.00151.0030;ESCO.0722.00151.0030i_04252;3821;4807;986
ESCO.0722.00151;ESCO.0722.00151.0032;ESCO.0722.00151.0032b_04348;37;1290;1253
ESCO.0722.00151;ESCO.0722.00151.0140;ESCO.0722.00151.0140b_04988;1;351;350
ESCO.0722.00151;ESCO.0722.00151.0269;ESCO.0722.00151.0269b_05116;1;213;212
ESCO.0722.00151;ESCO.0722.00151.0015;ESCO.0722.00151.0015i_03069;106833;107231;398
ESCO.0722.00151;ESCO.0722.00151.0025;ESCO.0722.00151.0025i_03965;3350;4867;1517
ESCO.0722.00151;ESCO.0722.00151.0030;ESCO.0722.00151.0030i_04253;4913;5845;932
ESCO.0722.00151;ESCO.0722.00151.0098;ESCO.0722.00151.0098b_04925;213;419;206
ESCO.0722.00151;ESCO.0722.00151.0270;ESCO.0722.00151.0270b_05117;2;211;209
ESCO.0722.00151;ESCO.0722.00151.0015;ESCO.0722.00151.0015i_03038;81312;81848;536
ESCO.0722.00151;ESCO.0722.00151.0015;ESCO.0722.00151.0015i_03070;107228;108220;992
ESCO.0722.00151;ESCO.0722.00151.0030;ESCO.0722.00151.0030i_04254;6184;8742;2558
ESCO.0722.00151;ESCO.0722.00151.0098;ESCO.0722.00151.0098b_04926;647;1534;887
ESCO.0722.00151;ESCO.0722.00151.0206;ESCO.0722.00151.0206b_05054;2;82;80
ESCO.0722.00151;ESCO.0722.00151.0271;ESCO.0722.00151.0271b_05118;2;208;206
ESCO.0722.00166;ESCO.0722.00166.0005;ESCO.0722.00166.0005i_01413;11156;12163;1007
ESCO.0722.00166;ESCO.0722.00166.0007;ESCO.0722.00166.0007i_01957;103030;104031;1001
ESCO.0722.00166;ESCO.0722.00166.0039;ESCO.0722.00166.0039b_04293;1;471;470
ESCO.0722.00166;ESCO.0722.00166.0040;ESCO.0722.00166.0040b_04325;21207;21488;281
ESCO.0722.00166;ESCO.0722.00166.0001;ESCO.0722.00166.0001i_00262;288434;288892;458
ESCO.0722.00166;ESCO.0722.00166.0005;ESCO.0722.00166.0005i_01414;12526;12657;131
ESCO.0722.00166;ESCO.0722.00166.0010;ESCO.0722.00166.0010i_02406;33503;33763;260
ESCO.0722.00166;ESCO.0722.00166.0012;ESCO.0722.00166.0012i_02630;8928;9362;434
ESCO.0722.00166;ESCO.0722.00166.0021;ESCO.0722.00166.0021i_03558;45788;46561;773
ESCO.0722.00166;ESCO.0722.00166.0072;ESCO.0722.00166.0072b_04646;1;132;131
ESCO.0722.00166;ESCO.0722.00166.0001;ESCO.0722.00166.0001i_00149;170700;170816;116
ESCO.0722.00166;ESCO.0722.00166.0001;ESCO.0722.00166.0001i_00245;268256;269119;863
ESCO.0722.00166;ESCO.0722.00166.0019;ESCO.0722.00166.0019b_03349;1;627;626
ESCO.0722.00166;ESCO.0722.00166.0038;ESCO.0722.00166.0038i_04277;2196;3245;1049
ESCO.0722.00166;ESCO.0722.00166.0050;ESCO.0722.00166.0050i_04501;4681;5631;950
ESCO.0722.00166;ESCO.0722.00166.0066;ESCO.0722.00166.0066i_04629;935;1168;233
ESCO.0722.00166;ESCO.0722.00166.0001;ESCO.0722.00166.0001i_00150;170813;171001;188
ESCO.0722.00166;ESCO.0722.00166.0001;ESCO.0722.00166.0001i_00246;269129;270598;1469
ESCO.0722.00166;ESCO.0722.00166.0004;ESCO.0722.00166.0004i_01334;190485;190910;425
ESCO.0722.00166;ESCO.0722.00166.0006;ESCO.0722.00166.0006b_01622;4;210;206
ESCO.0722.00166;ESCO.0722.00166.0019;ESCO.0722.00166.0019i_03350;629;955;326
ESCO.0722.00166;ESCO.0722.00166.0038;ESCO.0722.00166.0038i_04278;3340;5316;1976
ESCO.0722.00166;ESCO.0722.00166.0048;ESCO.0722.00166.0048b_04470;2;133;131
ESCO.0722.00166;ESCO.0722.00166.0050;ESCO.0722.00166.0050i_04502;5639;6052;413
ESCO.0722.00166;ESCO.0722.00166.0055;ESCO.0722.00166.0055b_04566;1;108;107
ESCO.0722.00166;ESCO.0722.00166.0066;ESCO.0722.00166.0066i_04630;1175;1735;560
ESCO.0722.00166;ESCO.0722.00166.0001;ESCO.0722.00166.0001i_00247;270701;271090;389
ESCO.0722.00166;ESCO.0722.00166.0001;ESCO.0722.00166.0001i_00311;340085;341725;1640
ESCO.0722.00166;ESCO.0722.00166.0014;ESCO.0722.00166.0014i_02935;62901;64928;2027
ESCO.0722.00166;ESCO.0722.00166.0040;ESCO.0722.00166.0040b_04311;99;1754;1655
ESCO.0722.00166;ESCO.0722.00166.0050;ESCO.0722.00166.0050i_04503;6338;6484;146
ESCO.0722.00166;ESCO.0722.00166.0055;ESCO.0722.00166.0055i_04567;53;631;578
ESCO.0722.00166;ESCO.0722.00166.0001;ESCO.0722.00166.0001i_00266;292513;293382;869
ESCO.0722.00166;ESCO.0722.00166.0005;ESCO.0722.00166.0005i_01418;17339;17959;620
ESCO.0722.00166;ESCO.0722.00166.0007;ESCO.0722.00166.0007i_02058;208263;209174;911
ESCO.0722.00166;ESCO.0722.00166.0019;ESCO.0722.00166.0019i_03370;18063;18470;407
ESCO.0722.00166;ESCO.0722.00166.0019;ESCO.0722.00166.0019i_03434;79470;79793;323
ESCO.0722.00166;ESCO.0722.00166.0025;ESCO.0722.00166.0025i_03818;49756;50112;356
ESCO.0722.00166;ESCO.0722.00166.0035;ESCO.0722.00166.0035i_04202;14101;14538;437
ESCO.0722.00166;ESCO.0722.00166.0043;ESCO.0722.00166.0043b_04394;19583;20266;683
ESCO.0722.00166;ESCO.0722.00166.0075;ESCO.0722.00166.0075b_04650;2;643;641
ESCO.0722.00166;ESCO.0722.00166.0132;ESCO.0722.00166.0132b_04714;1;96;95
ESCO.0722.00166;ESCO.0722.00166.0001;ESCO.0722.00166.0001i_00267;293452;293664;212
ESCO.0722.00166;ESCO.0722.00166.0002;ESCO.0722.00166.0002i_00651;84263;85105;842
ESCO.0722.00166;ESCO.0722.00166.0005;ESCO.0722.00166.0005i_01419;19668;20447;779
ESCO.0722.00166;ESCO.0722.00166.0007;ESCO.0722.00166.0007i_02059;209275;210060;785
ESCO.0722.00166;ESCO.0722.00166.0019;ESCO.0722.00166.0019i_03371;18627;18794;167
ESCO.0722.00166;ESCO.0722.00166.0019;ESCO.0722.00166.0019i_03435;80275;81132;857
ESCO.0722.00166;ESCO.0722.00166.0025;ESCO.0722.00166.0025i_03819;50334;52328;1994
ESCO.0722.00166;ESCO.0722.00166.0075;ESCO.0722.00166.0075i_04651;661;1041;380
ESCO.0722.00166;ESCO.0722.00166.0100;ESCO.0722.00166.0100b_04683;2;112;110
ESCO.0722.00166;ESCO.0722.00166.0135;ESCO.0722.00166.0135b_04715;3;188;185
ESCO.0722.00166;ESCO.0722.00166.0008;ESCO.0722.00166.0008i_02188;138720;139298;578
ESCO.0722.00166;ESCO.0722.00166.0001;ESCO.0722.00166.0001i_00509;552019;556782;4763
ESCO.0722.00166;ESCO.0722.00166.0004;ESCO.0722.00166.0004i_01341;199765;202245;2480
ESCO.0722.00166;ESCO.0722.00166.0012;ESCO.0722.00166.0012i_02749;121966;122976;1010
ESCO.0722.00166;ESCO.0722.00166.0019;ESCO.0722.00166.0019i_03357;5545;5940;395
ESCO.0722.00166;ESCO.0722.00166.0025;ESCO.0722.00166.0025i_03773;1303;1476;173
ESCO.0722.00166;ESCO.0722.00166.0026;ESCO.0722.00166.0026i_03837;17533;17709;176
ESCO.0722.00166;ESCO.0722.00166.0050;ESCO.0722.00166.0050i_04509;9199;11247;2048
ESCO.0722.00166;ESCO.0722.00166.0001;ESCO.0722.00166.0001i_00254;277934;278053;119
ESCO.0722.00166;ESCO.0722.00166.0001;ESCO.0722.00166.0001i_00350;386908;387186;278
ESCO.0722.00166;ESCO.0722.00166.0001;ESCO.0722.00166.0001i_00510;556857;557276;419
ESCO.0722.00166;ESCO.0722.00166.0004;ESCO.0722.00166.0004i_01342;202257;203483;1226
ESCO.0722.00166;ESCO.0722.00166.0012;ESCO.0722.00166.0012i_02750;122990;123295;305
ESCO.0722.00166;ESCO.0722.00166.0019;ESCO.0722.00166.0019i_03358;6553;6987;434
ESCO.0722.00166;ESCO.0722.00166.0019;ESCO.0722.00166.0019i_03422;73841;74539;698
ESCO.0722.00166;ESCO.0722.00166.0050;ESCO.0722.00166.0050b_04510;11252;12298;1046
ESCO.0722.00166;ESCO.0722.00166.0090;ESCO.0722.00166.0090b_04670;1;768;767
ESCO.0722.00166;ESCO.0722.00166.0115;ESCO.0722.00166.0115b_04702;2;445;443
ESCO.0722.00166;ESCO.0722.00166.0001;ESCO.0722.00166.0001i_00511;557269;559302;2033
ESCO.0722.00166;ESCO.0722.00166.0004;ESCO.0722.00166.0004i_01343;203428;204882;1454
ESCO.0722.00166;ESCO.0722.00166.0005;ESCO.0722.00166.0005i_01407;4219;5289;1070
ESCO.0722.00166;ESCO.0722.00166.0019;ESCO.0722.00166.0019i_03423;74670;75218;548
ESCO.0722.00166;ESCO.0722.00166.0070;ESCO.0722.00166.0070b_04639;2;124;122
ESCO.0722.00166;ESCO.0722.00166.0091;ESCO.0722.00166.0091b_04671;22;762;740
ESCO.0722.00166;ESCO.0722.00166.0005;ESCO.0722.00166.0005i_01412;10080;11132;1052
ESCO.0722.00166;ESCO.0722.00166.0007;ESCO.0722.00166.0007i_01956;102711;103019;308
ESCO.0722.00166;ESCO.0722.00166.0015;ESCO.0722.00166.0015b_03076;103039;103407;368
ESCO.0722.00166;ESCO.0722.00166.0040;ESCO.0722.00166.0040i_04324;19240;21066;1826
ESCO.0722.00166;ESCO.0722.00166.0001;ESCO.0722.00166.0001i_00283;307624;307749;125
ESCO.0722.00166;ESCO.0722.00166.0001;ESCO.0722.00166.0001i_00507;550660;551481;821
ESCO.0722.00166;ESCO.0722.00166.0004;ESCO.0722.00166.0004i_01339;198621;198764;143
ESCO.0722.00166;ESCO.0722.00166.0024;ESCO.0722.00166.0024b_03707;1;450;449
ESCO.0722.00166;ESCO.0722.00166.0025;ESCO.0722.00166.0025b_03771;136;489;353
ESCO.0722.00166;ESCO.0722.00166.0042;ESCO.0722.00166.0042b_04379;20185;20403;218
ESCO.0722.00166;ESCO.0722.00166.0050;ESCO.0722.00166.0050i_04507;8297;8704;407
ESCO.0722.00166;ESCO.0722.00166.0068;ESCO.0722.00166.0068i_04635;2167;2748;581
ESCO.0722.00166;ESCO.0722.00166.0088;ESCO.0722.00166.0088b_04667;267;794;527
ESCO.0722.00166;ESCO.0722.00166.0001;ESCO.0722.00166.0001i_00508;551629;551757;128
ESCO.0722.00166;ESCO.0722.00166.0004;ESCO.0722.00166.0004i_01340;199079;199732;653
ESCO.0722.00166;ESCO.0722.00166.0025;ESCO.0722.00166.0025i_03772;705;1046;341
ESCO.0722.00166;ESCO.0722.00166.0043;ESCO.0722.00166.0043b_04380;140;2233;2093
ESCO.0722.00166;ESCO.0722.00166.0050;ESCO.0722.00166.0050i_04508;8747;8950;203
ESCO.0722.00166;ESCO.0722.00166.0068;ESCO.0722.00166.0068b_04636;2741;2893;152
ESCO.0722.00166;ESCO.0722.00166.0089;ESCO.0722.00166.0089b_04668;1;129;128
ESCO.0722.00166;ESCO.0722.00166.0003;ESCO.0722.00166.0003i_00911;46204;46446;242
ESCO.0722.00166;ESCO.0722.00166.0009;ESCO.0722.00166.0009i_02319;107151;107372;221
ESCO.0722.00166;ESCO.0722.00166.0077;ESCO.0722.00166.0077b_04655;1;1272;1271
ESCO.0722.00166;ESCO.0722.00166.0102;ESCO.0722.00166.0102b_04687;2;517;515
ESCO.0722.00166;ESCO.0722.00166.0005;ESCO.0722.00166.0005i_01456;70289;70681;392
ESCO.0722.00166;ESCO.0722.00166.0007;ESCO.0722.00166.0007i_01968;116340;116657;317
ESCO.0722.00166;ESCO.0722.00166.0009;ESCO.0722.00166.0009i_02320;107369;107746;377
ESCO.0722.00166;ESCO.0722.00166.0038;ESCO.0722.00166.0038b_04272;1;369;368
ESCO.0722.00166;ESCO.0722.00166.0051;ESCO.0722.00166.0051i_04528;10545;10970;425
ESCO.0722.00166;ESCO.0722.00166.0057;ESCO.0722.00166.0057b_04592;5301;7028;1727
ESCO.0722.00166;ESCO.0722.00166.0078;ESCO.0722.00166.0078b_04656;3;791;788
ESCO.0722.00166;ESCO.0722.00166.0005;ESCO.0722.00166.0005i_01457;70685;71704;1019
ESCO.0722.00166;ESCO.0722.00166.0038;ESCO.0722.00166.0038i_04273;398;655;257
ESCO.0722.00166;ESCO.0722.00166.0050;ESCO.0722.00166.0050b_04497;1;1701;1700
ESCO.0722.00166;ESCO.0722.00166.0051;ESCO.0722.00166.0051i_04529;10985;11479;494
ESCO.0722.00166;ESCO.0722.00166.0065;ESCO.0722.00166.0065b_04625;2;1888;1886
ESCO.0722.00166;ESCO.0722.00166.0078;ESCO.0722.00166.0078b_04657;794;1195;401
ESCO.0722.00166;ESCO.0722.00166.0141;ESCO.0722.00166.0141b_04721;1;144;143
ESCO.0722.00166;ESCO.0722.00166.0019;ESCO.0722.00166.0019i_03436;81260;81973;713
ESCO.0722.00166;ESCO.0722.00166.0025;ESCO.0722.00166.0025i_03820;52379;52831;452
ESCO.0722.00166;ESCO.0722.00166.0075;ESCO.0722.00166.0075b_04652;1107;1460;353
ESCO.0722.00166;ESCO.0722.00166.0136;ESCO.0722.00166.0136b_04716;70;165;95
ESCO.0722.00166;ESCO.0722.00166.0005;ESCO.0722.00166.0005i_01485;95098;95373;275
ESCO.0722.00166;ESCO.0722.00166.0008;ESCO.0722.00166.0008i_02189;139365;141002;1637
ESCO.0722.00166;ESCO.0722.00166.0009;ESCO.0722.00166.0009i_02349;141366;141998;632
ESCO.0722.00166;ESCO.0722.00166.0019;ESCO.0722.00166.0019i_03437;82074;82274;200
ESCO.0722.00166;ESCO.0722.00166.0025;ESCO.0722.00166.0025b_03821;52850;53365;515
ESCO.0722.00166;ESCO.0722.00166.0101;ESCO.0722.00166.0101b_04685;3;212;209
ESCO.0722.00166;ESCO.0722.00166.0137;ESCO.0722.00166.0137b_04717;1;159;158
ESCO.0722.00166;ESCO.0722.00166.0008;ESCO.0722.00166.0008i_02222;172696;172911;215
ESCO.0722.00166;ESCO.0722.00166.0031;ESCO.0722.00166.0031b_04046;3;257;254
ESCO.0722.00166;ESCO.0722.00166.0001;ESCO.0722.00166.0001i_00248;271100;272542;1442
ESCO.0722.00166;ESCO.0722.00166.0002;ESCO.0722.00166.0002i_00568;1049;2116;1067
ESCO.0722.00166;ESCO.0722.00166.0002;ESCO.0722.00166.0002i_00824;285552;285860;308
ESCO.0722.00166;ESCO.0722.00166.0050;ESCO.0722.00166.0050i_04504;6700;7239;539
ESCO.0722.00166;ESCO.0722.00166.0059;ESCO.0722.00166.0059b_04600;108;356;248
ESCO.0722.00166;ESCO.0722.00166.0001;ESCO.0722.00166.0001i_00249;272743;273963;1220
ESCO.0722.00166;ESCO.0722.00166.0002;ESCO.0722.00166.0002i_00569;2116;2658;542
ESCO.0722.00166;ESCO.0722.00166.0002;ESCO.0722.00166.0002i_00665;99974;100213;239
ESCO.0722.00166;ESCO.0722.00166.0002;ESCO.0722.00166.0002i_00697;139244;139333;89
ESCO.0722.00166;ESCO.0722.00166.0005;ESCO.0722.00166.0005i_01497;112653;112817;164
ESCO.0722.00166;ESCO.0722.00166.0019;ESCO.0722.00166.0019i_03353;2786;3430;644
ESCO.0722.00166;ESCO.0722.00166.0019;ESCO.0722.00166.0019i_03385;35327;35539;212
ESCO.0722.00166;ESCO.0722.00166.0050;ESCO.0722.00166.0050i_04505;7250;7699;449
ESCO.0722.00166;ESCO.0722.00166.0068;ESCO.0722.00166.0068b_04633;2;541;539
ESCO.0722.00166;ESCO.0722.00166.0019;ESCO.0722.00166.0019i_03354;3430;3798;368
ESCO.0722.00166;ESCO.0722.00166.0026;ESCO.0722.00166.0026i_03834;13908;15782;1874
ESCO.0722.00166;ESCO.0722.00166.0050;ESCO.0722.00166.0050i_04506;7683;8225;542
ESCO.0722.00166;ESCO.0722.00166.0001;ESCO.0722.00166.0001i_00039;39903;40121;218
ESCO.0722.00166;ESCO.0722.00166.0001;ESCO.0722.00166.0001i_00263;288841;289377;536
ESCO.0722.00166;ESCO.0722.00166.0004;ESCO.0722.00166.0004i_01351;213512;213769;257
ESCO.0722.00166;ESCO.0722.00166.0005;ESCO.0722.00166.0005i_01415;13851;15038;1187
ESCO.0722.00166;ESCO.0722.00166.0021;ESCO.0722.00166.0021i_03559;46596;47849;1253
ESCO.0722.00166;ESCO.0722.00166.0023;ESCO.0722.00166.0023i_03655;8330;8422;92
ESCO.0722.00166;ESCO.0722.00166.0049;ESCO.0722.00166.0049i_04487;5717;6259;542
ESCO.0722.00166;ESCO.0722.00166.0062;ESCO.0722.00166.0062i_04615;885;1193;308
ESCO.0722.00166;ESCO.0722.00166.0072;ESCO.0722.00166.0072b_04647;132;1754;1622
ESCO.0722.00166;ESCO.0722.00166.0004;ESCO.0722.00166.0004i_01384;252388;252600;212
ESCO.0722.00166;ESCO.0722.00166.0005;ESCO.0722.00166.0005i_01416;15035;16294;1259
ESCO.0722.00166;ESCO.0722.00166.0007;ESCO.0722.00166.0007i_01864;1811;2080;269
ESCO.0722.00166;ESCO.0722.00166.0027;ESCO.0722.00166.0027i_03880;18235;18357;122
ESCO.0722.00166;ESCO.0722.00166.0005;ESCO.0722.00166.0005i_01417;16297;17334;1037
ESCO.0722.00166;ESCO.0722.00166.0007;ESCO.0722.00166.0007i_02057;207396;208190;794
ESCO.0722.00166;ESCO.0722.00166.0019;ESCO.0722.00166.0019i_03433;79049;79477;428
ESCO.0722.00166;ESCO.0722.00166.0025;ESCO.0722.00166.0025i_03817;49229;49759;530
ESCO.0722.00166;ESCO.0722.00166.0130;ESCO.0722.00166.0130b_04713;1;234;233
ESCO.0722.00166;ESCO.0722.00166.0038;ESCO.0722.00166.0038i_04274;648;950;302
ESCO.0722.00166;ESCO.0722.00166.0050;ESCO.0722.00166.0050i_04498;1744;2328;584
ESCO.0722.00166;ESCO.0722.00166.0051;ESCO.0722.00166.0051b_04530;11603;11983;380
ESCO.0722.00166;ESCO.0722.00166.0050;ESCO.0722.00166.0050i_04499;2341;3456;1115
ESCO.0722.00166;ESCO.0722.00166.0018;ESCO.0722.00166.0018b_03348;91489;92334;845
ESCO.0722.00166;ESCO.0722.00166.0038;ESCO.0722.00166.0038i_04276;1571;2122;551
ESCO.0722.00166;ESCO.0722.00166.0050;ESCO.0722.00166.0050i_04500;3620;4087;467
ESCO.0722.00166;ESCO.0722.00166.0066;ESCO.0722.00166.0066b_04628;1;720;719
ESCO.0722.00166;ESCO.0722.00166.0144;ESCO.0722.00166.0144b_04724;28;123;95
ESCO.0722.00166;ESCO.0722.00166.0005;ESCO.0722.00166.0005i_01411;8871;9881;1010
ESCO.0722.00166;ESCO.0722.00166.0013;ESCO.0722.00166.0013b_02755;97;828;731
ESCO.0722.00166;ESCO.0722.00166.0094;ESCO.0722.00166.0094b_04675;2;373;371
ESCO.0722.00166;ESCO.0722.00166.0001;ESCO.0722.00166.0001i_00512;559295;560857;1562
ESCO.0722.00166;ESCO.0722.00166.0048;ESCO.0722.00166.0048i_04480;13106;13546;440
ESCO.0722.00166;ESCO.0722.00166.0118;ESCO.0722.00166.0118b_04704;1;411;410
ESCO.0722.00166;ESCO.0722.00166.0001;ESCO.0722.00166.0001i_00257;281089;282486;1397
ESCO.0722.00166;ESCO.0722.00166.0001;ESCO.0722.00166.0001i_00417;451256;451354;98
ESCO.0722.00166;ESCO.0722.00166.0001;ESCO.0722.00166.0001i_00513;560844;562034;1190
ESCO.0722.00166;ESCO.0722.00166.0005;ESCO.0722.00166.0005i_01409;7288;7572;284
ESCO.0722.00166;ESCO.0722.00166.0005;ESCO.0722.00166.0005i_01569;193162;193959;797
ESCO.0722.00166;ESCO.0722.00166.0032;ESCO.0722.00166.0032i_04097;6067;6189;122
ESCO.0722.00166;ESCO.0722.00166.0048;ESCO.0722.00166.0048i_04481;13641;13784;143
ESCO.0722.00166;ESCO.0722.00166.0003;ESCO.0722.00166.0003i_00930;70118;70291;173
ESCO.0722.00166;ESCO.0722.00166.0005;ESCO.0722.00166.0005i_01410;7600;7941;341
ESCO.0722.00166;ESCO.0722.00166.0040;ESCO.0722.00166.0040i_04322;17662;18762;1100
ESCO.0722.00166;ESCO.0722.00166.0120;ESCO.0722.00166.0120b_04706;1;360;359
ESCO.0722.00169;ESCO.0722.00169.0001;ESCO.0722.00169.0001i_00112;104018;104818;800
ESCO.0722.00169;ESCO.0722.00169.0002;ESCO.0722.00169.0002i_00752;337657;338325;668
ESCO.0722.00169;ESCO.0722.00169.0011;ESCO.0722.00169.0011i_02512;181526;182059;533
ESCO.0722.00169;ESCO.0722.00169.0044;ESCO.0722.00169.0044i_04176;5539;6486;947
ESCO.0722.00169;ESCO.0722.00169.0053;ESCO.0722.00169.0053i_04304;2955;5081;2126
ESCO.0722.00169;ESCO.0722.00169.0059;ESCO.0722.00169.0059i_04368;5859;5993;134
ESCO.0722.00169;ESCO.0722.00169.0067;ESCO.0722.00169.0067i_04400;2216;2647;431
ESCO.0722.00169;ESCO.0722.00169.0184;ESCO.0722.00169.0184b_04560;1;78;77
ESCO.0722.00169;ESCO.0722.00169.0002;ESCO.0722.00169.0002i_00753;339344;340210;866
ESCO.0722.00169;ESCO.0722.00169.0006;ESCO.0722.00169.0006i_01233;134876;134974;98
ESCO.0722.00169;ESCO.0722.00169.0016;ESCO.0722.00169.0016b_03025;129250;129921;671
ESCO.0722.00169;ESCO.0722.00169.0044;ESCO.0722.00169.0044i_04177;6538;9924;3386
ESCO.0722.00169;ESCO.0722.00169.0053;ESCO.0722.00169.0053i_04305;5285;5995;710
ESCO.0722.00169;ESCO.0722.00169.0059;ESCO.0722.00169.0059i_04369;6359;6808;449
ESCO.0722.00169;ESCO.0722.00169.0092;ESCO.0722.00169.0092b_04465;1;1095;1094
ESCO.0722.00169;ESCO.0722.00169.0122;ESCO.0722.00169.0122b_04497;2;133;131
ESCO.0722.00169;ESCO.0722.00169.0185;ESCO.0722.00169.0185b_04561;86;205;119
ESCO.0722.00169;ESCO.0722.00169.0002;ESCO.0722.00169.0002i_00608;174577;175659;1082
ESCO.0722.00169;ESCO.0722.00169.0048;ESCO.0722.00169.0048i_04224;9520;9750;230
ESCO.0722.00169;ESCO.0722.00169.0050;ESCO.0722.00169.0050b_04256;14334;14483;149
ESCO.0722.00169;ESCO.0722.00169.0055;ESCO.0722.00169.0055b_04320;28;378;350
ESCO.0722.00169;ESCO.0722.00169.0063;ESCO.0722.00169.0063b_04384;1;234;233
ESCO.0722.00169;ESCO.0722.00169.0070;ESCO.0722.00169.0070b_04416;4004;4087;83
ESCO.0722.00169;ESCO.0722.00169.0082;ESCO.0722.00169.0082b_04448;27;1397;1370
ESCO.0722.00169;ESCO.0722.00169.0105;ESCO.0722.00169.0105b_04480;2;154;152
ESCO.0722.00169;ESCO.0722.00169.0133;ESCO.0722.00169.0133b_04512;2;289;287
ESCO.0722.00169;ESCO.0722.00169.0166;ESCO.0722.00169.0166b_04544;3;221;218
ESCO.0722.00169;ESCO.0722.00169.0009;ESCO.0722.00169.0009i_02113;198508;198843;335
ESCO.0722.00169;ESCO.0722.00169.0039;ESCO.0722.00169.0039i_04065;15004;16164;1160
ESCO.0722.00169;ESCO.0722.00169.0071;ESCO.0722.00169.0071b_04417;253;492;239
ESCO.0722.00169;ESCO.0722.00169.0105;ESCO.0722.00169.0105b_04481;245;556;311
ESCO.0722.00169;ESCO.0722.00169.0167;ESCO.0722.00169.0167b_04545;2;223;221
ESCO.0722.00169;ESCO.0722.00169.0009;ESCO.0722.00169.0009i_02114;198851;199591;740
ESCO.0722.00169;ESCO.0722.00169.0071;ESCO.0722.00169.0071i_04418;543;650;107
ESCO.0722.00169;ESCO.0722.00169.0084;ESCO.0722.00169.0084b_04450;2;124;122
ESCO.0722.00169;ESCO.0722.00169.0106;ESCO.0722.00169.0106b_04482;1;552;551
ESCO.0722.00169;ESCO.0722.00169.0168;ESCO.0722.00169.0168b_04546;2;220;218
ESCO.0722.00169;ESCO.0722.00169.0001;ESCO.0722.00169.0001i_00405;403478;403891;413
ESCO.0722.00169;ESCO.0722.00169.0002;ESCO.0722.00169.0002i_00533;101250;101936;686
ESCO.0722.00169;ESCO.0722.00169.0002;ESCO.0722.00169.0002i_00757;342736;343107;371
ESCO.0722.00169;ESCO.0722.00169.0013;ESCO.0722.00169.0013i_02677;16018;16293;275
ESCO.0722.00169;ESCO.0722.00169.0018;ESCO.0722.00169.0018i_03221;106817;107077;260
ESCO.0722.00169;ESCO.0722.00169.0050;ESCO.0722.00169.0050i_04245;3180;3383;203
ESCO.0722.00169;ESCO.0722.00169.0076;ESCO.0722.00169.0076b_04437;2150;2287;137
ESCO.0722.00169;ESCO.0722.00169.0125;ESCO.0722.00169.0125b_04501;2;316;314
ESCO.0722.00169;ESCO.0722.00169.0190;ESCO.0722.00169.0190b_04565;3;158;155
ESCO.0722.00169;ESCO.0722.00169.0002;ESCO.0722.00169.0002i_00534;102122;102766;644
ESCO.0722.00169;ESCO.0722.00169.0002;ESCO.0722.00169.0002i_00758;343085;344023;938
ESCO.0722.00169;ESCO.0722.00169.0006;ESCO.0722.00169.0006i_01302;210369;210605;236
ESCO.0722.00169;ESCO.0722.00169.0018;ESCO.0722.00169.0018b_03222;107104;107607;503
ESCO.0722.00169;ESCO.0722.00169.0053;ESCO.0722.00169.0053b_04310;10232;10711;479
ESCO.0722.00169;ESCO.0722.00169.0097;ESCO.0722.00169.0097b_04470;1;174;173
ESCO.0722.00169;ESCO.0722.00169.0126;ESCO.0722.00169.0126b_04502;2;313;311
ESCO.0722.00169;ESCO.0722.00169.0006;ESCO.0722.00169.0006i_01352;272091;272507;416
ESCO.0722.00169;ESCO.0722.00169.0007;ESCO.0722.00169.0007i_01480;103690;103932;242
ESCO.0722.00169;ESCO.0722.00169.0011;ESCO.0722.00169.0011i_02504;173909;174100;191
ESCO.0722.00169;ESCO.0722.00169.0021;ESCO.0722.00169.0021b_03400;4033;5868;1835
ESCO.0722.00169;ESCO.0722.00169.0051;ESCO.0722.00169.0051i_04264;2908;3285;377
ESCO.0722.00169;ESCO.0722.00169.0073;ESCO.0722.00169.0073b_04424;1;453;452
ESCO.0722.00169;ESCO.0722.00169.0176;ESCO.0722.00169.0176b_04552;1;216;215
ESCO.0722.00169;ESCO.0722.00169.0006;ESCO.0722.00169.0006i_01353;272523;272750;227
ESCO.0722.00169;ESCO.0722.00169.0007;ESCO.0722.00169.0007i_01385;2432;2878;446
ESCO.0722.00169;ESCO.0722.00169.0007;ESCO.0722.00169.0007i_01673;324211;324765;554
ESCO.0722.00169;ESCO.0722.00169.0022;ESCO.0722.00169.0022b_03401;1;354;353
ESCO.0722.00169;ESCO.0722.00169.0028;ESCO.0722.00169.0028b_03657;1169;1417;248
ESCO.0722.00169;ESCO.0722.00169.0051;ESCO.0722.00169.0051i_04265;3282;3710;428
ESCO.0722.00169;ESCO.0722.00169.0059;ESCO.0722.00169.0059i_04361;1427;2659;1232
ESCO.0722.00169;ESCO.0722.00169.0073;ESCO.0722.00169.0073i_04425;519;1337;818
ESCO.0722.00169;ESCO.0722.00169.0087;ESCO.0722.00169.0087b_04457;608;1417;809
ESCO.0722.00169;ESCO.0722.00169.0113;ESCO.0722.00169.0113b_04489;3;380;377
ESCO.0722.00169;ESCO.0722.00169.0177;ESCO.0722.00169.0177b_04553;2;106;104
ESCO.0722.00169;ESCO.0722.00169.0001;ESCO.0722.00169.0001i_00074;64683;66350;1667
ESCO.0722.00169;ESCO.0722.00169.0001;ESCO.0722.00169.0001i_00426;421435;421722;287
ESCO.0722.00169;ESCO.0722.00169.0022;ESCO.0722.00169.0022i_03402;1463;2347;884
ESCO.0722.00169;ESCO.0722.00169.0028;ESCO.0722.00169.0028i_03658;1935;3191;1256
ESCO.0722.00169;ESCO.0722.00169.0032;ESCO.0722.00169.0032i_03882;31257;31445;188
ESCO.0722.00169;ESCO.0722.00169.0059;ESCO.0722.00169.0059i_04362;2997;3689;692
ESCO.0722.00169;ESCO.0722.00169.0073;ESCO.0722.00169.0073i_04426;1351;1944;593
ESCO.0722.00169;ESCO.0722.00169.0177;ESCO.0722.00169.0177b_04554;146;211;65
ESCO.0722.00169;ESCO.0722.00169.0001;ESCO.0722.00169.0001i_00111;102389;103978;1589
ESCO.0722.00169;ESCO.0722.00169.0002;ESCO.0722.00169.0002i_00751;336884;337660;776
ESCO.0722.00169;ESCO.0722.00169.0034;ESCO.0722.00169.0034b_03919;3;86;83
ESCO.0722.00169;ESCO.0722.00169.0042;ESCO.0722.00169.0042i_04143;27417;27962;545
ESCO.0722.00169;ESCO.0722.00169.0044;ESCO.0722.00169.0044i_04175;5063;5527;464
ESCO.0722.00169;ESCO.0722.00169.0047;ESCO.0722.00169.0047b_04207;144;530;386
ESCO.0722.00169;ESCO.0722.00169.0053;ESCO.0722.00169.0053i_04303;1614;2924;1310
ESCO.0722.00169;ESCO.0722.00169.0059;ESCO.0722.00169.0059i_04367;4733;5548;815
ESCO.0722.00169;ESCO.0722.00169.0067;ESCO.0722.00169.0067i_04399;1728;2027;299
ESCO.0722.00169;ESCO.0722.00169.0150;ESCO.0722.00169.0150b_04527;1;186;185
ESCO.0722.00169;ESCO.0722.00169.0182;ESCO.0722.00169.0182b_04559;3;206;203
ESCO.0722.00169;ESCO.0722.00169.0018;ESCO.0722.00169.0018i_03205;87031;87366;335
ESCO.0722.00169;ESCO.0722.00169.0138;ESCO.0722.00169.0138b_04517;3;281;278
ESCO.0722.00169;ESCO.0722.00169.0173;ESCO.0722.00169.0173b_04549;3;218;215
ESCO.0722.00169;ESCO.0722.00169.0001;ESCO.0722.00169.0001i_00422;418707;419579;872
ESCO.0722.00169;ESCO.0722.00169.0018;ESCO.0722.00169.0018i_03206;87505;87657;152
ESCO.0722.00169;ESCO.0722.00169.0048;ESCO.0722.00169.0048b_04230;14996;15058;62
ESCO.0722.00169;ESCO.0722.00169.0110;ESCO.0722.00169.0110b_04486;3;170;167
ESCO.0722.00169;ESCO.0722.00169.0139;ESCO.0722.00169.0139b_04518;2;280;278
ESCO.0722.00169;ESCO.0722.00169.0174;ESCO.0722.00169.0174b_04550;145;216;71
ESCO.0722.00169;ESCO.0722.00169.0007;ESCO.0722.00169.0007i_01479;103246;103683;437
ESCO.0722.00169;ESCO.0722.00169.0086;ESCO.0722.00169.0086b_04455;846;1418;572
ESCO.0722.00169;ESCO.0722.00169.0175;ESCO.0722.00169.0175b_04551;2;136;134
ESCO.0722.00169;ESCO.0722.00169.0001;ESCO.0722.00169.0001i_00218;210767;212716;1949
ESCO.0722.00169;ESCO.0722.00169.0016;ESCO.0722.00169.0016i_03002;106858;107178;320
ESCO.0722.00169;ESCO.0722.00169.0044;ESCO.0722.00169.0044i_04186;15797;16375;578
ESCO.0722.00169;ESCO.0722.00169.0048;ESCO.0722.00169.0048i_04218;1913;2959;1046
ESCO.0722.00169;ESCO.0722.00169.0050;ESCO.0722.00169.0050i_04250;8017;8568;551
ESCO.0722.00169;ESCO.0722.00169.0057;ESCO.0722.00169.0057i_04346;2521;5028;2507
ESCO.0722.00169;ESCO.0722.00169.0161;ESCO.0722.00169.0161b_04538;3;227;224
ESCO.0722.00169;ESCO.0722.00169.0202;ESCO.0722.00169.0202b_04570;3;113;110
ESCO.0722.00169;ESCO.0722.00169.0016;ESCO.0722.00169.0016i_03003;107227;107931;704
ESCO.0722.00169;ESCO.0722.00169.0048;ESCO.0722.00169.0048i_04219;2964;5924;2960
ESCO.0722.00169;ESCO.0722.00169.0057;ESCO.0722.00169.0057i_04347;5101;5532;431
ESCO.0722.00169;ESCO.0722.00169.0070;ESCO.0722.00169.0070b_04411;37;1101;1064
ESCO.0722.00169;ESCO.0722.00169.0079;ESCO.0722.00169.0079b_04443;1881;2081;200
ESCO.0722.00169;ESCO.0722.00169.0102;ESCO.0722.00169.0102b_04475;2;595;593
ESCO.0722.00169;ESCO.0722.00169.0162;ESCO.0722.00169.0162b_04539;2;226;224
ESCO.0722.00169;ESCO.0722.00169.0203;ESCO.0722.00169.0203b_04571;3;110;107
ESCO.0722.00169;ESCO.0722.00169.0048;ESCO.0722.00169.0048i_04220;5938;7605;1667
ESCO.0722.00169;ESCO.0722.00169.0051;ESCO.0722.00169.0051b_04284;12738;13319;581
ESCO.0722.00169;ESCO.0722.00169.0057;ESCO.0722.00169.0057i_04348;5513;6214;701
ESCO.0722.00169;ESCO.0722.00169.0103;ESCO.0722.00169.0103b_04476;3;575;572
ESCO.0722.00169;ESCO.0722.00169.0163;ESCO.0722.00169.0163b_04540;2;109;107
ESCO.0722.00169;ESCO.0722.00169.0002;ESCO.0722.00169.0002i_00759;344377;346506;2129
ESCO.0722.00169;ESCO.0722.00169.0006;ESCO.0722.00169.0006i_01335;248893;249033;140
ESCO.0722.00169;ESCO.0722.00169.0011;ESCO.0722.00169.0011i_02519;190717;190890;173
ESCO.0722.00169;ESCO.0722.00169.0020;ESCO.0722.00169.0020i_03351;45504;45878;374
ESCO.0722.00169;ESCO.0722.00169.0057;ESCO.0722.00169.0057b_04343;258;1523;1265
ESCO.0722.00169;ESCO.0722.00169.0002;ESCO.0722.00169.0002b_00760;346543;347793;1250
ESCO.0722.00169;ESCO.0722.00169.0011;ESCO.0722.00169.0011i_02520;190835;190978;143
ESCO.0722.00169;ESCO.0722.00169.0012;ESCO.0722.00169.0012i_02648;135002;135343;341
ESCO.0722.00169;ESCO.0722.00169.0025;ESCO.0722.00169.0025i_03576;44221;44613;392
ESCO.0722.00169;ESCO.0722.00169.0044;ESCO.0722.00169.0044i_04184;14438;14956;518
ESCO.0722.00169;ESCO.0722.00169.0048;ESCO.0722.00169.0048i_04216;639;1166;527
ESCO.0722.00169;ESCO.0722.00169.0057;ESCO.0722.00169.0057i_04344;1543;2076;533
ESCO.0722.00169;ESCO.0722.00169.0078;ESCO.0722.00169.0078b_04440;332;2083;1751
ESCO.0722.00169;ESCO.0722.00169.0099;ESCO.0722.00169.0099b_04472;3;629;626
ESCO.0722.00169;ESCO.0722.00169.0159;ESCO.0722.00169.0159b_04536;48;233;185
ESCO.0722.00169;ESCO.0722.00169.0042;ESCO.0722.00169.0042b_04121;2;82;80
ESCO.0722.00169;ESCO.0722.00169.0044;ESCO.0722.00169.0044i_04185;14956;15774;818
ESCO.0722.00169;ESCO.0722.00169.0048;ESCO.0722.00169.0048i_04217;1176;1532;356
ESCO.0722.00169;ESCO.0722.00169.0057;ESCO.0722.00169.0057i_04345;2081;2533;452
ESCO.0722.00169;ESCO.0722.00169.0100;ESCO.0722.00169.0100b_04473;1;600;599
ESCO.0722.00169;ESCO.0722.00169.0128;ESCO.0722.00169.0128b_04505;1;309;308
ESCO.0722.00169;ESCO.0722.00169.0160;ESCO.0722.00169.0160b_04537;2;229;227
ESCO.0722.00169;ESCO.0722.00169.0058;ESCO.0722.00169.0058i_04355;3771;4826;1055
ESCO.0722.00169;ESCO.0722.00169.0107;ESCO.0722.00169.0107b_04483;2;517;515
ESCO.0722.00169;ESCO.0722.00169.0169;ESCO.0722.00169.0169b_04547;1;219;218
ESCO.0722.00169;ESCO.0722.00169.0137;ESCO.0722.00169.0137b_04516;2;286;284
ESCO.0722.00169;ESCO.0722.00169.0171;ESCO.0722.00169.0171b_04548;101;220;119
ESCO.0722.00169;ESCO.0722.00169.0008;ESCO.0722.00169.0008i_01701;18657;18833;176
ESCO.0722.00169;ESCO.0722.00169.0002;ESCO.0722.00169.0002i_00754;340207;341196;989
ESCO.0722.00169;ESCO.0722.00169.0011;ESCO.0722.00169.0011b_02354;1;474;473
ESCO.0722.00169;ESCO.0722.00169.0044;ESCO.0722.00169.0044i_04178;9951;11105;1154
ESCO.0722.00169;ESCO.0722.00169.0053;ESCO.0722.00169.0053i_04306;6289;7785;1496
ESCO.0722.00169;ESCO.0722.00169.0067;ESCO.0722.00169.0067b_04402;4061;4267;206
ESCO.0722.00169;ESCO.0722.00169.0152;ESCO.0722.00169.0152b_04530;62;235;173
ESCO.0722.00169;ESCO.0722.00169.0002;ESCO.0722.00169.0002i_00755;341196;342152;956
ESCO.0722.00169;ESCO.0722.00169.0011;ESCO.0722.00169.0011i_02355;467;1255;788
ESCO.0722.00169;ESCO.0722.00169.0018;ESCO.0722.00169.0018i_03219;101725;102474;749
ESCO.0722.00169;ESCO.0722.00169.0032;ESCO.0722.00169.0032i_03891;41707;42675;968
ESCO.0722.00169;ESCO.0722.00169.0044;ESCO.0722.00169.0044i_04179;11121;11378;257
ESCO.0722.00169;ESCO.0722.00169.0053;ESCO.0722.00169.0053i_04307;7832;8719;887
ESCO.0722.00169;ESCO.0722.00169.0076;ESCO.0722.00169.0076b_04435;189;863;674
ESCO.0722.00169;ESCO.0722.00169.0153;ESCO.0722.00169.0153b_04531;1;156;155
ESCO.0722.00169;ESCO.0722.00169.0188;ESCO.0722.00169.0188b_04563;3;143;140
ESCO.0722.00169;ESCO.0722.00169.0002;ESCO.0722.00169.0002i_00756;342149;342787;638
ESCO.0722.00169;ESCO.0722.00169.0011;ESCO.0722.00169.0011i_02356;1340;2260;920
ESCO.0722.00169;ESCO.0722.00169.0018;ESCO.0722.00169.0018i_03220;102743;106594;3851
ESCO.0722.00169;ESCO.0722.00169.0044;ESCO.0722.00169.0044i_04180;11405;12991;1586
ESCO.0722.00169;ESCO.0722.00169.0050;ESCO.0722.00169.0050b_04244;1263;2840;1577
ESCO.0722.00169;ESCO.0722.00169.0056;ESCO.0722.00169.0056i_04340;7385;7969;584
ESCO.0722.00169;ESCO.0722.00169.0076;ESCO.0722.00169.0076i_04436;1003;1629;626
ESCO.0722.00169;ESCO.0722.00169.0124;ESCO.0722.00169.0124b_04500;2;325;323
ESCO.0722.00169;ESCO.0722.00169.0189;ESCO.0722.00169.0189b_04564;3;164;161
ESCO.0722.00169;ESCO.0722.00169.0044;ESCO.0722.00169.0044i_04189;18353;19531;1178
ESCO.0722.00169;ESCO.0722.00169.0048;ESCO.0722.00169.0048i_04221;8286;8552;266
ESCO.0722.00169;ESCO.0722.00169.0057;ESCO.0722.00169.0057i_04349;6270;6860;590
ESCO.0722.00169;ESCO.0722.00169.0061;ESCO.0722.00169.0061b_04381;3836;5107;1271
ESCO.0722.00169;ESCO.0722.00169.0163;ESCO.0722.00169.0163b_04541;109;228;119
ESCO.0722.00169;ESCO.0722.00169.0209;ESCO.0722.00169.0209b_04573;1;93;92
ESCO.0722.00169;ESCO.0722.00169.0002;ESCO.0722.00169.0002i_00606;171895;172236;341
ESCO.0722.00169;ESCO.0722.00169.0022;ESCO.0722.00169.0022i_03422;18673;18840;167
ESCO.0722.00169;ESCO.0722.00169.0044;ESCO.0722.00169.0044b_04190;19524;20711;1187
ESCO.0722.00169;ESCO.0722.00169.0057;ESCO.0722.00169.0057i_04350;7010;7882;872
ESCO.0722.00169;ESCO.0722.00169.0062;ESCO.0722.00169.0062b_04382;3;1100;1097
ESCO.0722.00169;ESCO.0722.00169.0070;ESCO.0722.00169.0070i_04414;2892;3101;209
ESCO.0722.00169;ESCO.0722.00169.0081;ESCO.0722.00169.0081b_04446;2;478;476
ESCO.0722.00169;ESCO.0722.00169.0164;ESCO.0722.00169.0164b_04542;1;96;95
ESCO.0722.00169;ESCO.0722.00169.0048;ESCO.0722.00169.0048i_04223;9040;9129;89
ESCO.0722.00169;ESCO.0722.00169.0057;ESCO.0722.00169.0057b_04351;8479;8652;173
ESCO.0722.00169;ESCO.0722.00169.0132;ESCO.0722.00169.0132b_04511;1;297;296
ESCO.0722.00169;ESCO.0722.00169.0165;ESCO.0722.00169.0165b_04543;2;223;221
ESCO.0722.00169;ESCO.0722.00169.0012;ESCO.0722.00169.0012i_02574;54946;55035;89
ESCO.0722.00169;ESCO.0722.00169.0044;ESCO.0722.00169.0044i_04174;4446;5066;620
ESCO.0722.00169;ESCO.0722.00169.0059;ESCO.0722.00169.0059i_04366;4413;4625;212
ESCO.0722.00169;ESCO.0722.00169.0181;ESCO.0722.00169.0181b_04558;17;211;194
ESCO.0722.00169;ESCO.0722.00169.0022;ESCO.0722.00169.0022i_03403;2371;2868;497
ESCO.0722.00169;ESCO.0722.00169.0028;ESCO.0722.00169.0028i_03659;3255;4187;932
ESCO.0722.00169;ESCO.0722.00169.0028;ESCO.0722.00169.0028b_03723;73433;73513;80
ESCO.0722.00169;ESCO.0722.00169.0044;ESCO.0722.00169.0044i_04171;2990;3319;329
ESCO.0722.00169;ESCO.0722.00169.0052;ESCO.0722.00169.0052i_04299;10003;11451;1448
ESCO.0722.00169;ESCO.0722.00169.0059;ESCO.0722.00169.0059i_04363;3713;3889;176
ESCO.0722.00169;ESCO.0722.00169.0145;ESCO.0722.00169.0145b_04523;3;254;251
ESCO.0722.00169;ESCO.0722.00169.0178;ESCO.0722.00169.0178b_04555;50;211;161
ESCO.0722.00169;ESCO.0722.00169.0022;ESCO.0722.00169.0022i_03404;2998;3183;185
ESCO.0722.00169;ESCO.0722.00169.0028;ESCO.0722.00169.0028i_03660;4184;5128;944
ESCO.0722.00169;ESCO.0722.00169.0044;ESCO.0722.00169.0044i_04172;3335;3736;401
ESCO.0722.00169;ESCO.0722.00169.0052;ESCO.0722.00169.0052b_04300;11501;11866;365
ESCO.0722.00169;ESCO.0722.00169.0059;ESCO.0722.00169.0059i_04364;4032;4202;170
ESCO.0722.00169;ESCO.0722.00169.0067;ESCO.0722.00169.0067b_04396;15;245;230
ESCO.0722.00169;ESCO.0722.00169.0074;ESCO.0722.00169.0074b_04428;2;88;86
ESCO.0722.00169;ESCO.0722.00169.0117;ESCO.0722.00169.0117b_04492;2;313;311
ESCO.0722.00169;ESCO.0722.00169.0146;ESCO.0722.00169.0146b_04524;162;251;89
ESCO.0722.00169;ESCO.0722.00169.0179;ESCO.0722.00169.0179b_04556;1;210;209
ESCO.0722.00169;ESCO.0722.00169.0001;ESCO.0722.00169.0001i_00077;68016;69398;1382
ESCO.0722.00169;ESCO.0722.00169.0027;ESCO.0722.00169.0027i_03597;2834;4153;1319
ESCO.0722.00169;ESCO.0722.00169.0044;ESCO.0722.00169.0044i_04173;3769;4434;665
ESCO.0722.00169;ESCO.0722.00169.0053;ESCO.0722.00169.0053b_04301;382;564;182
ESCO.0722.00169;ESCO.0722.00169.0059;ESCO.0722.00169.0059i_04365;4199;4459;260
ESCO.0722.00169;ESCO.0722.00169.0074;ESCO.0722.00169.0074i_04429;1071;1352;281
ESCO.0722.00169;ESCO.0722.00169.0147;ESCO.0722.00169.0147b_04525;1;189;188
ESCO.0722.00169;ESCO.0722.00169.0180;ESCO.0722.00169.0180b_04557;2;211;209
ESCO.0722.00170;ESCO.0722.00170.0001;ESCO.0722.00170.0001i_00144;158494;159747;1253
ESCO.0722.00170;ESCO.0722.00170.0004;ESCO.0722.00170.0004i_00784;259387;259536;149
ESCO.0722.00170;ESCO.0722.00170.0007;ESCO.0722.00170.0007i_01200;20387;21658;1271
ESCO.0722.00170;ESCO.0722.00170.0010;ESCO.0722.00170.0010i_02000;96221;97210;989
ESCO.0722.00170;ESCO.0722.00170.0031;ESCO.0722.00170.0031i_03952;48650;49615;965
ESCO.0722.00170;ESCO.0722.00170.0037;ESCO.0722.00170.0037i_04208;11354;11842;488
ESCO.0722.00170;ESCO.0722.00170.0043;ESCO.0722.00170.0043i_04464;19348;28674;9326
ESCO.0722.00170;ESCO.0722.00170.0208;ESCO.0722.00170.0208b_04880;1;105;104
ESCO.0722.00170;ESCO.0722.00170.0001;ESCO.0722.00170.0001i_00145;159799;162561;2762
ESCO.0722.00170;ESCO.0722.00170.0002;ESCO.0722.00170.0002i_00465;33043;33363;320
ESCO.0722.00170;ESCO.0722.00170.0004;ESCO.0722.00170.0004i_00785;259791;260510;719
ESCO.0722.00170;ESCO.0722.00170.0007;ESCO.0722.00170.0007i_01201;21655;22782;1127
ESCO.0722.00170;ESCO.0722.00170.0010;ESCO.0722.00170.0010i_02001;97223;97450;227
ESCO.0722.00170;ESCO.0722.00170.0030;ESCO.0722.00170.0030i_03825;32737;33171;434
ESCO.0722.00170;ESCO.0722.00170.0030;ESCO.0722.00170.0030i_03857;52719;53666;947
ESCO.0722.00170;ESCO.0722.00170.0037;ESCO.0722.00170.0037i_04209;11797;12168;371
ESCO.0722.00170;ESCO.0722.00170.0040;ESCO.0722.00170.0040i_04401;34869;35183;314
ESCO.0722.00170;ESCO.0722.00170.0002;ESCO.0722.00170.0002i_00480;42221;43492;1271
ESCO.0722.00170;ESCO.0722.00170.0023;ESCO.0722.00170.0023i_03392;73983;75056;1073
ESCO.0722.00170;ESCO.0722.00170.0040;ESCO.0722.00170.0040i_04352;4742;5104;362
ESCO.0722.00170;ESCO.0722.00170.0002;ESCO.0722.00170.0002i_00481;43851;44522;671
ESCO.0722.00170;ESCO.0722.00170.0003;ESCO.0722.00170.0003i_00545;21093;21200;107
ESCO.0722.00170;ESCO.0722.00170.0023;ESCO.0722.00170.0023i_03393;75177;76013;836
ESCO.0722.00170;ESCO.0722.00170.0028;ESCO.0722.00170.0028i_03777;79757;80053;296
ESCO.0722.00170;ESCO.0722.00170.0031;ESCO.0722.00170.0031i_03937;40397;41134;737
ESCO.0722.00170;ESCO.0722.00170.0040;ESCO.0722.00170.0040i_04353;5101;5493;392
ESCO.0722.00170;ESCO.0722.00170.0095;ESCO.0722.00170.0095b_04769;1;615;614
ESCO.0722.00170;ESCO.0722.00170.0149;ESCO.0722.00170.0149b_04833;1;282;281
ESCO.0722.00170;ESCO.0722.00170.0001;ESCO.0722.00170.0001i_00002;2504;2743;239
ESCO.0722.00170;ESCO.0722.00170.0002;ESCO.0722.00170.0002i_00450;19930;20658;728
ESCO.0722.00170;ESCO.0722.00170.0002;ESCO.0722.00170.0002i_00482;44823;46445;1622
ESCO.0722.00170;ESCO.0722.00170.0003;ESCO.0722.00170.0003i_00546;21197;21304;107
ESCO.0722.00170;ESCO.0722.00170.0031;ESCO.0722.00170.0031i_03938;41131;41367;236
ESCO.0722.00170;ESCO.0722.00170.0073;ESCO.0722.00170.0073b_04738;831;1121;290
ESCO.0722.00170;ESCO.0722.00170.0122;ESCO.0722.00170.0122b_04802;2;340;338
ESCO.0722.00170;ESCO.0722.00170.0150;ESCO.0722.00170.0150b_04834;3;275;272
ESCO.0722.00170;ESCO.0722.00170.0003;ESCO.0722.00170.0003i_00533;13589;13900;311
ESCO.0722.00170;ESCO.0722.00170.0007;ESCO.0722.00170.0007i_01205;29964;30812;848
ESCO.0722.00170;ESCO.0722.00170.0028;ESCO.0722.00170.0028i_03765;67066;67908;842
ESCO.0722.00170;ESCO.0722.00170.0031;ESCO.0722.00170.0031i_03925;31565;31675;110
ESCO.0722.00170;ESCO.0722.00170.0036;ESCO.0722.00170.0036i_04149;3450;3674;224
ESCO.0722.00170;ESCO.0722.00170.0040;ESCO.0722.00170.0040i_04373;13999;14211;212
ESCO.0722.00170;ESCO.0722.00170.0040;ESCO.0722.00170.0040i_04405;36779;38770;1991
ESCO.0722.00170;ESCO.0722.00170.0170;ESCO.0722.00170.0170b_04853;1;210;209
ESCO.0722.00170;ESCO.0722.00170.0215;ESCO.0722.00170.0215b_04885;1;72;71
ESCO.0722.00170;ESCO.0722.00170.0002;ESCO.0722.00170.0002i_00470;35330;36397;1067
ESCO.0722.00170;ESCO.0722.00170.0007;ESCO.0722.00170.0007i_01206;30809;34015;3206
ESCO.0722.00170;ESCO.0722.00170.0030;ESCO.0722.00170.0030i_03862;54940;55563;623
ESCO.0722.00170;ESCO.0722.00170.0171;ESCO.0722.00170.0171b_04854;23;205;182
ESCO.0722.00170;ESCO.0722.00170.0001;ESCO.0722.00170.0001i_00104;111999;112517;518
ESCO.0722.00170;ESCO.0722.00170.0009;ESCO.0722.00170.0009i_01896;216867;217370;503
ESCO.0722.00170;ESCO.0722.00170.0010;ESCO.0722.00170.0010i_01992;85809;88187;2378
ESCO.0722.00170;ESCO.0722.00170.0037;ESCO.0722.00170.0037i_04232;35213;36616;1403
ESCO.0722.00170;ESCO.0722.00170.0048;ESCO.0722.00170.0048i_04616;19073;19291;218
ESCO.0722.00170;ESCO.0722.00170.0052;ESCO.0722.00170.0052b_04680;3;65;62
ESCO.0722.00170;ESCO.0722.00170.0001;ESCO.0722.00170.0001i_00105;112709;113497;788
ESCO.0722.00170;ESCO.0722.00170.0010;ESCO.0722.00170.0010i_01993;88520;90670;2150
ESCO.0722.00170;ESCO.0722.00170.0021;ESCO.0722.00170.0021i_03209;91660;92283;623
ESCO.0722.00170;ESCO.0722.00170.0030;ESCO.0722.00170.0030i_03849;48881;49747;866
ESCO.0722.00170;ESCO.0722.00170.0032;ESCO.0722.00170.0032i_04041;43505;44380;875
ESCO.0722.00170;ESCO.0722.00170.0037;ESCO.0722.00170.0037i_04233;36665;39115;2450
ESCO.0722.00170;ESCO.0722.00170.0040;ESCO.0722.00170.0040i_04361;7985;8260;275
ESCO.0722.00170;ESCO.0722.00170.0048;ESCO.0722.00170.0048i_04617;19571;20605;1034
ESCO.0722.00170;ESCO.0722.00170.0157;ESCO.0722.00170.0157b_04841;3;242;239
ESCO.0722.00170;ESCO.0722.00170.0007;ESCO.0722.00170.0007i_01194;16642;16938;296
ESCO.0722.00170;ESCO.0722.00170.0010;ESCO.0722.00170.0010i_01994;90949;91956;1007
ESCO.0722.00170;ESCO.0722.00170.0021;ESCO.0722.00170.0021i_03210;92261;92710;449
ESCO.0722.00170;ESCO.0722.00170.0031;ESCO.0722.00170.0031i_03946;45858;46076;218
ESCO.0722.00170;ESCO.0722.00170.0040;ESCO.0722.00170.0040i_04362;8257;8400;143
ESCO.0722.00170;ESCO.0722.00170.0048;ESCO.0722.00170.0048i_04618;20641;21480;839
ESCO.0722.00170;ESCO.0722.00170.0001;ESCO.0722.00170.0001i_00143;157272;158411;1139
ESCO.0722.00170;ESCO.0722.00170.0007;ESCO.0722.00170.0007i_01199;19378;20334;956
ESCO.0722.00170;ESCO.0722.00170.0010;ESCO.0722.00170.0010i_01999;95160;95426;266
ESCO.0722.00170;ESCO.0722.00170.0019;ESCO.0722.00170.0019i_02927;71756;73105;1349
ESCO.0722.00170;ESCO.0722.00170.0019;ESCO.0722.00170.0019i_02959;108313;108642;329
ESCO.0722.00170;ESCO.0722.00170.0029;ESCO.0722.00170.0029b_03791;2;397;395
ESCO.0722.00170;ESCO.0722.00170.0040;ESCO.0722.00170.0040i_04399;32241;34355;2114
ESCO.0722.00170;ESCO.0722.00170.0048;ESCO.0722.00170.0048b_04623;28605;29102;497
ESCO.0722.00170;ESCO.0722.00170.0164;ESCO.0722.00170.0164b_04847;2;232;230
ESCO.0722.00170;ESCO.0722.00170.0002;ESCO.0722.00170.0002i_00485;49991;51505;1514
ESCO.0722.00170;ESCO.0722.00170.0003;ESCO.0722.00170.0003i_00549;21958;22278;320
ESCO.0722.00170;ESCO.0722.00170.0004;ESCO.0722.00170.0004i_00677;136096;136431;335
ESCO.0722.00170;ESCO.0722.00170.0008;ESCO.0722.00170.0008i_01477;13953;14831;878
ESCO.0722.00170;ESCO.0722.00170.0015;ESCO.0722.00170.0015b_02597;2998;3618;620
ESCO.0722.00170;ESCO.0722.00170.0040;ESCO.0722.00170.0040i_04357;6262;6768;506
ESCO.0722.00170;ESCO.0722.00170.0059;ESCO.0722.00170.0059b_04709;143;1102;959
ESCO.0722.00170;ESCO.0722.00170.0125;ESCO.0722.00170.0125b_04805;200;334;134
ESCO.0722.00170;ESCO.0722.00170.0153;ESCO.0722.00170.0153b_04837;1;258;257
ESCO.0722.00170;ESCO.0722.00170.0002;ESCO.0722.00170.0002i_00486;51532;51744;212
ESCO.0722.00170;ESCO.0722.00170.0003;ESCO.0722.00170.0003i_00550;22375;23379;1004
ESCO.0722.00170;ESCO.0722.00170.0008;ESCO.0722.00170.0008i_01478;14837;15247;410
ESCO.0722.00170;ESCO.0722.00170.0009;ESCO.0722.00170.0009i_01894;215787;216137;350
ESCO.0722.00170;ESCO.0722.00170.0025;ESCO.0722.00170.0025i_03558;35429;35674;245
ESCO.0722.00170;ESCO.0722.00170.0048;ESCO.0722.00170.0048i_04614;18381;18728;347
ESCO.0722.00170;ESCO.0722.00170.0002;ESCO.0722.00170.0002i_00487;51881;52747;866
ESCO.0722.00170;ESCO.0722.00170.0009;ESCO.0722.00170.0009i_01895;216317;216889;572
ESCO.0722.00170;ESCO.0722.00170.0019;ESCO.0722.00170.0019i_02887;19862;19954;92
ESCO.0722.00170;ESCO.0722.00170.0048;ESCO.0722.00170.0048i_04615;18837;19037;200
ESCO.0722.00170;ESCO.0722.00170.0155;ESCO.0722.00170.0155b_04839;130;249;119
ESCO.0722.00170;ESCO.0722.00170.0195;ESCO.0722.00170.0195b_04871;1;123;122
ESCO.0722.00170;ESCO.0722.00170.0001;ESCO.0722.00170.0001i_00346;398579;399124;545
ESCO.0722.00170;ESCO.0722.00170.0019;ESCO.0722.00170.0019i_02874;5655;6218;563
ESCO.0722.00170;ESCO.0722.00170.0002;ESCO.0722.00170.0002i_00475;39732;40022;290
ESCO.0722.00170;ESCO.0722.00170.0007;ESCO.0722.00170.0007i_01211;41471;41641;170
ESCO.0722.00170;ESCO.0722.00170.0031;ESCO.0722.00170.0031i_03931;34458;34895;437
ESCO.0722.00170;ESCO.0722.00170.0040;ESCO.0722.00170.0040i_04347;2035;2334;299
ESCO.0722.00170;ESCO.0722.00170.0043;ESCO.0722.00170.0043b_04475;34393;34872;479
ESCO.0722.00170;ESCO.0722.00170.0089;ESCO.0722.00170.0089b_04763;1;720;719
ESCO.0722.00170;ESCO.0722.00170.0002;ESCO.0722.00170.0002i_00476;40137;40721;584
ESCO.0722.00170;ESCO.0722.00170.0007;ESCO.0722.00170.0007i_01212;42843;43586;743
ESCO.0722.00170;ESCO.0722.00170.0118;ESCO.0722.00170.0118b_04796;186;359;173
ESCO.0722.00170;ESCO.0722.00170.0002;ESCO.0722.00170.0002i_00471;36555;36662;107
ESCO.0722.00170;ESCO.0722.00170.0007;ESCO.0722.00170.0007i_01207;34012;34887;875
ESCO.0722.00170;ESCO.0722.00170.0031;ESCO.0722.00170.0031i_03927;32222;32665;443
ESCO.0722.00170;ESCO.0722.00170.0053;ESCO.0722.00170.0053b_04695;5816;6280;464
ESCO.0722.00170;ESCO.0722.00170.0115;ESCO.0722.00170.0115b_04791;2;175;173
ESCO.0722.00170;ESCO.0722.00170.0002;ESCO.0722.00170.0002i_00472;36688;37398;710
ESCO.0722.00170;ESCO.0722.00170.0007;ESCO.0722.00170.0007i_01208;34874;37354;2480
ESCO.0722.00170;ESCO.0722.00170.0031;ESCO.0722.00170.0031i_03928;32682;33059;377
ESCO.0722.00170;ESCO.0722.00170.0044;ESCO.0722.00170.0044i_04504;31165;31509;344
ESCO.0722.00170;ESCO.0722.00170.0087;ESCO.0722.00170.0087b_04760;2;451;449
ESCO.0722.00170;ESCO.0722.00170.0007;ESCO.0722.00170.0007i_01209;37354;40461;3107
ESCO.0722.00170;ESCO.0722.00170.0030;ESCO.0722.00170.0030i_03865;56262;56654;392
ESCO.0722.00170;ESCO.0722.00170.0031;ESCO.0722.00170.0031i_03929;33063;33545;482
ESCO.0722.00170;ESCO.0722.00170.0044;ESCO.0722.00170.0044i_04505;31568;31768;200
ESCO.0722.00170;ESCO.0722.00170.0001;ESCO.0722.00170.0001i_00003;2795;3574;779
ESCO.0722.00170;ESCO.0722.00170.0002;ESCO.0722.00170.0002i_00483;46551;48692;2141
ESCO.0722.00170;ESCO.0722.00170.0003;ESCO.0722.00170.0003b_00515;3;1187;1184
ESCO.0722.00170;ESCO.0722.00170.0003;ESCO.0722.00170.0003i_00547;21344;21550;206
ESCO.0722.00170;ESCO.0722.00170.0031;ESCO.0722.00170.0031i_03939;41544;43895;2351
ESCO.0722.00170;ESCO.0722.00170.0074;ESCO.0722.00170.0074b_04739;3;1097;1094
ESCO.0722.00170;ESCO.0722.00170.0151;ESCO.0722.00170.0151b_04835;3;269;266
ESCO.0722.00170;ESCO.0722.00170.0002;ESCO.0722.00170.0002i_00484;49034;49732;698
ESCO.0722.00170;ESCO.0722.00170.0003;ESCO.0722.00170.0003i_00548;21557;21844;287
ESCO.0722.00170;ESCO.0722.00170.0020;ESCO.0722.00170.0020i_03108;106755;107696;941
ESCO.0722.00170;ESCO.0722.00170.0028;ESCO.0722.00170.0028i_03780;80972;81994;1022
ESCO.0722.00170;ESCO.0722.00170.0059;ESCO.0722.00170.0059b_04708;1;162;161
ESCO.0722.00170;ESCO.0722.00170.0097;ESCO.0722.00170.0097b_04772;3;530;527
ESCO.0722.00170;ESCO.0722.00170.0001;ESCO.0722.00170.0001i_00146;162574;163311;737
ESCO.0722.00170;ESCO.0722.00170.0007;ESCO.0722.00170.0007i_01202;22806;24989;2183
ESCO.0722.00170;ESCO.0722.00170.0010;ESCO.0722.00170.0010i_02002;97538;98572;1034
ESCO.0722.00170;ESCO.0722.00170.0030;ESCO.0722.00170.0030i_03826;33171;33335;164
ESCO.0722.00170;ESCO.0722.00170.0111;ESCO.0722.00170.0111b_04786;3;113;110
ESCO.0722.00170;ESCO.0722.00170.0001;ESCO.0722.00170.0001i_00147;163951;164625;674
ESCO.0722.00170;ESCO.0722.00170.0007;ESCO.0722.00170.0007i_01203;24982;25512;530
ESCO.0722.00170;ESCO.0722.00170.0010;ESCO.0722.00170.0010i_02003;99066;100256;1190
ESCO.0722.00170;ESCO.0722.00170.0030;ESCO.0722.00170.0030i_03827;33335;33442;107
ESCO.0722.00170;ESCO.0722.00170.0031;ESCO.0722.00170.0031i_03923;31102;31353;251
ESCO.0722.00170;ESCO.0722.00170.0040;ESCO.0722.00170.0040i_04371;11714;12544;830
ESCO.0722.00170;ESCO.0722.00170.0040;ESCO.0722.00170.0040i_04403;35536;35682;146
ESCO.0722.00170;ESCO.0722.00170.0003;ESCO.0722.00170.0003i_00532;12955;13224;269
ESCO.0722.00170;ESCO.0722.00170.0007;ESCO.0722.00170.0007i_01204;25524;29960;4436
ESCO.0722.00170;ESCO.0722.00170.0030;ESCO.0722.00170.0030i_03860;54282;54404;122
ESCO.0722.00170;ESCO.0722.00170.0031;ESCO.0722.00170.0031i_03924;31313;31429;116
ESCO.0722.00170;ESCO.0722.00170.0112;ESCO.0722.00170.0112b_04788;3;386;383
ESCO.0722.00170;ESCO.0722.00170.0169;ESCO.0722.00170.0169b_04852;3;218;215
ESCO.0722.00170;ESCO.0722.00170.0214;ESCO.0722.00170.0214b_04884;1;81;80
ESCO.0722.00170;ESCO.0722.00170.0002;ESCO.0722.00170.0002i_00477;40660;41280;620
ESCO.0722.00170;ESCO.0722.00170.0003;ESCO.0722.00170.0003i_00541;19579;19995;416
ESCO.0722.00170;ESCO.0722.00170.0040;ESCO.0722.00170.0040i_04349;2770;3399;629
ESCO.0722.00170;ESCO.0722.00170.0048;ESCO.0722.00170.0048i_04605;10642;11316;674
ESCO.0722.00170;ESCO.0722.00170.0001;ESCO.0722.00170.0001i_00190;209957;210079;122
ESCO.0722.00170;ESCO.0722.00170.0002;ESCO.0722.00170.0002i_00478;41378;41497;119
ESCO.0722.00170;ESCO.0722.00170.0002;ESCO.0722.00170.0002i_00479;41442;42224;782
ESCO.0722.00170;ESCO.0722.00170.0040;ESCO.0722.00170.0040i_04351;4167;4745;578
ESCO.0722.00170;ESCO.0722.00170.0001;ESCO.0722.00170.0001i_00142;156237;157226;989
ESCO.0722.00170;ESCO.0722.00170.0007;ESCO.0722.00170.0007i_01198;19046;19279;233
ESCO.0722.00170;ESCO.0722.00170.0008;ESCO.0722.00170.0008i_01614;148334;149986;1652
ESCO.0722.00170;ESCO.0722.00170.0010;ESCO.0722.00170.0010i_01998;94197;94991;794
ESCO.0722.00170;ESCO.0722.00170.0040;ESCO.0722.00170.0040i_04398;30970;32241;1271
ESCO.0722.00170;ESCO.0722.00170.0048;ESCO.0722.00170.0048i_04622;26559;28538;1979
ESCO.0722.00170;ESCO.0722.00170.0007;ESCO.0722.00170.0007i_01195;17482;17901;419
ESCO.0722.00170;ESCO.0722.00170.0010;ESCO.0722.00170.0010i_01995;92108;92536;428
ESCO.0722.00170;ESCO.0722.00170.0020;ESCO.0722.00170.0020i_03115;111734;113281;1547
ESCO.0722.00170;ESCO.0722.00170.0031;ESCO.0722.00170.0031i_03947;46069;46263;194
ESCO.0722.00170;ESCO.0722.00170.0040;ESCO.0722.00170.0040i_04363;8568;8810;242
ESCO.0722.00170;ESCO.0722.00170.0048;ESCO.0722.00170.0048i_04619;21483;22037;554
ESCO.0722.00170;ESCO.0722.00170.0159;ESCO.0722.00170.0159b_04843;3;242;239
ESCO.0722.00170;ESCO.0722.00170.0201;ESCO.0722.00170.0201b_04875;3;110;107
ESCO.0722.00170;ESCO.0722.00170.0007;ESCO.0722.00170.0007i_01196;17901;18008;107
ESCO.0722.00170;ESCO.0722.00170.0010;ESCO.0722.00170.0010i_01996;92618;94009;1391
ESCO.0722.00170;ESCO.0722.00170.0048;ESCO.0722.00170.0048i_04620;22037;25273;3236
ESCO.0722.00170;ESCO.0722.00170.0129;ESCO.0722.00170.0129b_04812;3;332;329
ESCO.0722.00170;ESCO.0722.00170.0001;ESCO.0722.00170.0001i_00013;15902;16303;401
ESCO.0722.00170;ESCO.0722.00170.0001;ESCO.0722.00170.0001i_00141;154875;155867;992
ESCO.0722.00170;ESCO.0722.00170.0001;ESCO.0722.00170.0001i_00205;221635;222171;536
ESCO.0722.00170;ESCO.0722.00170.0007;ESCO.0722.00170.0007i_01197;18539;18829;290
ESCO.0722.00170;ESCO.0722.00170.0010;ESCO.0722.00170.0010i_01997;94012;94185;173
ESCO.0722.00170;ESCO.0722.00170.0019;ESCO.0722.00170.0019b_02989;126437;126871;434
ESCO.0722.00170;ESCO.0722.00170.0020;ESCO.0722.00170.0020i_03117;114906;115142;236
ESCO.0722.00170;ESCO.0722.00170.0030;ESCO.0722.00170.0030i_03853;51423;51611;188
ESCO.0722.00170;ESCO.0722.00170.0040;ESCO.0722.00170.0040i_04365;9242;9574;332
ESCO.0722.00170;ESCO.0722.00170.0048;ESCO.0722.00170.0048i_04621;25273;26559;1286
ESCO.0722.00170;ESCO.0722.00170.0081;ESCO.0722.00170.0081b_04749;1;165;164
ESCO.0722.00201;ESCO.0722.00201.0029;ESCO.0722.00201.0029i_03706;35192;36016;824
ESCO.0722.00201;ESCO.0722.00201.0029;ESCO.0722.00201.0029i_03770;98929;99528;599
ESCO.0722.00201;ESCO.0722.00201.0032;ESCO.0722.00201.0032i_03994;45235;45633;398
ESCO.0722.00201;ESCO.0722.00201.0079;ESCO.0722.00201.0079b_04794;261;1172;911
ESCO.0722.00201;ESCO.0722.00201.0205;ESCO.0722.00201.0205b_04986;3;272;269
ESCO.0722.00201;ESCO.0722.00201.0238;ESCO.0722.00201.0238b_05018;47;226;179
ESCO.0722.00201;ESCO.0722.00201.0009;ESCO.0722.00201.0009i_01275;61886;62446;560
ESCO.0722.00201;ESCO.0722.00201.0011;ESCO.0722.00201.0011b_01627;3;416;413
ESCO.0722.00201;ESCO.0722.00201.0102;ESCO.0722.00201.0102b_04859;1174;1332;158
ESCO.0722.00201;ESCO.0722.00201.0141;ESCO.0722.00201.0141b_04923;2;649;647
ESCO.0722.00201;ESCO.0722.00201.0011;ESCO.0722.00201.0011i_01642;13607;14257;650
ESCO.0722.00201;ESCO.0722.00201.0154;ESCO.0722.00201.0154b_04938;3;173;170
ESCO.0722.00201;ESCO.0722.00201.0257;ESCO.0722.00201.0257b_05034;3;206;203
ESCO.0722.00201;ESCO.0722.00201.0297;ESCO.0722.00201.0297b_05066;2;115;113
ESCO.0722.00201;ESCO.0722.00201.0011;ESCO.0722.00201.0011i_01643;14564;15604;1040
ESCO.0722.00201;ESCO.0722.00201.0188;ESCO.0722.00201.0188b_04971;213;305;92
ESCO.0722.00201;ESCO.0722.00201.0010;ESCO.0722.00201.0010b_01388;3;1382;1379
ESCO.0722.00201;ESCO.0722.00201.0029;ESCO.0722.00201.0029i_03660;1952;2476;524
ESCO.0722.00201;ESCO.0722.00201.0156;ESCO.0722.00201.0156b_04940;304;420;116
ESCO.0722.00201;ESCO.0722.00201.0258;ESCO.0722.00201.0258b_05036;79;204;125
ESCO.0722.00201;ESCO.0722.00201.0036;ESCO.0722.00201.0036i_04223;33523;33786;263
ESCO.0722.00201;ESCO.0722.00201.0144;ESCO.0722.00201.0144b_04927;3;419;416
ESCO.0722.00201;ESCO.0722.00201.0283;ESCO.0722.00201.0283b_05055;3;134;131
ESCO.0722.00201;ESCO.0722.00201.0332;ESCO.0722.00201.0332b_05087;3;80;77
ESCO.0722.00201;ESCO.0722.00201.0039;ESCO.0722.00201.0039i_04384;29663;30169;506
ESCO.0722.00201;ESCO.0722.00201.0178;ESCO.0722.00201.0178b_04960;1;327;326
ESCO.0722.00201;ESCO.0722.00201.0285;ESCO.0722.00201.0285b_05056;3;134;131
ESCO.0722.00201;ESCO.0722.00201.0003;ESCO.0722.00201.0003i_00498;18249;18860;611
ESCO.0722.00201;ESCO.0722.00201.0029;ESCO.0722.00201.0029i_03666;4794;5315;521
ESCO.0722.00201;ESCO.0722.00201.0196;ESCO.0722.00201.0196b_04978;1;288;287
ESCO.0722.00201;ESCO.0722.00201.0313;ESCO.0722.00201.0313b_05074;2;106;104
ESCO.0722.00201;ESCO.0722.00201.0003;ESCO.0722.00201.0003i_00499;18871;19347;476
ESCO.0722.00201;ESCO.0722.00201.0029;ESCO.0722.00201.0029i_03667;5312;5635;323
ESCO.0722.00201;ESCO.0722.00201.0029;ESCO.0722.00201.0029i_03699;30739;31833;1094
ESCO.0722.00201;ESCO.0722.00201.0134;ESCO.0722.00201.0134b_04915;1;681;680
ESCO.0722.00201;ESCO.0722.00201.0163;ESCO.0722.00201.0163b_04947;2;397;395
ESCO.0722.00201;ESCO.0722.00201.0230;ESCO.0722.00201.0230b_05011;162;239;77
ESCO.0722.00201;ESCO.0722.00201.0025;ESCO.0722.00201.0025b_03316;3;464;461
ESCO.0722.00201;ESCO.0722.00201.0029;ESCO.0722.00201.0029i_03668;5637;6167;530
ESCO.0722.00201;ESCO.0722.00201.0029;ESCO.0722.00201.0029i_03732;61513;63207;1694
ESCO.0722.00201;ESCO.0722.00201.0264;ESCO.0722.00201.0264b_05044;3;170;167
ESCO.0722.00201;ESCO.0722.00201.0029;ESCO.0722.00201.0029i_03705;34404;35144;740
ESCO.0722.00201;ESCO.0722.00201.0029;ESCO.0722.00201.0029i_03769;98425;98913;488
ESCO.0722.00201;ESCO.0722.00201.0088;ESCO.0722.00201.0088b_04825;1983;2096;113
ESCO.0722.00201;ESCO.0722.00201.0139;ESCO.0722.00201.0139b_04921;1;654;653
ESCO.0722.00201;ESCO.0722.00201.0235;ESCO.0722.00201.0235b_05017;122;232;110
ESCO.0722.00201;ESCO.0722.00201.0272;ESCO.0722.00201.0272b_05049;2;151;149
ESCO.0722.00201;ESCO.0722.00201.0029;ESCO.0722.00201.0029i_03663;3555;4130;575
ESCO.0722.00201;ESCO.0722.00201.0084;ESCO.0722.00201.0084b_04815;2622;3233;611
ESCO.0722.00201;ESCO.0722.00201.0193;ESCO.0722.00201.0193b_04975;1;294;293
ESCO.0722.00201;ESCO.0722.00201.0060;ESCO.0722.00201.0060b_04688;1;474;473
ESCO.0722.00201;ESCO.0722.00201.0194;ESCO.0722.00201.0194b_04976;2;289;287
ESCO.0722.00201;ESCO.0722.00201.0228;ESCO.0722.00201.0228b_05008;157;240;83
ESCO.0722.00201;ESCO.0722.00201.0310;ESCO.0722.00201.0310b_05072;1;108;107
ESCO.0722.00201;ESCO.0722.00201.0003;ESCO.0722.00201.0003i_00497;17743;18150;407
ESCO.0722.00201;ESCO.0722.00201.0023;ESCO.0722.00201.0023b_03057;1;123;122
ESCO.0722.00201;ESCO.0722.00201.0063;ESCO.0722.00201.0063b_04721;6609;6743;134
ESCO.0722.00201;ESCO.0722.00201.0085;ESCO.0722.00201.0085b_04817;762;3122;2360
ESCO.0722.00201;ESCO.0722.00201.0229;ESCO.0722.00201.0229b_05009;3;110;107
ESCO.0722.00201;ESCO.0722.00201.0029;ESCO.0722.00201.0029i_03780;104891;105109;218
ESCO.0722.00201;ESCO.0722.00201.0106;ESCO.0722.00201.0106b_04868;1026;1208;182
ESCO.0722.00201;ESCO.0722.00201.0029;ESCO.0722.00201.0029i_03781;105762;105983;221
ESCO.0722.00201;ESCO.0722.00201.0082;ESCO.0722.00201.0082b_04805;3771;3863;92
ESCO.0722.00201;ESCO.0722.00201.0252;ESCO.0722.00201.0252b_05029;22;210;188
ESCO.0722.00201;ESCO.0722.00201.0291;ESCO.0722.00201.0291b_05061;2;127;125
ESCO.0722.00201;ESCO.0722.00201.0340;ESCO.0722.00201.0340b_05093;1;72;71
ESCO.0722.00201;ESCO.0722.00201.0029;ESCO.0722.00201.0029i_03782;106651;106836;185
ESCO.0722.00201;ESCO.0722.00201.0083;ESCO.0722.00201.0083b_04806;179;958;779
ESCO.0722.00201;ESCO.0722.00201.0150;ESCO.0722.00201.0150b_04934;2;490;488
ESCO.0722.00201;ESCO.0722.00201.0184;ESCO.0722.00201.0184b_04966;2;310;308
ESCO.0722.00201;ESCO.0722.00201.0253;ESCO.0722.00201.0253b_05030;3;209;206
ESCO.0722.00201;ESCO.0722.00201.0039;ESCO.0722.00201.0039i_04353;1998;4460;2462
ESCO.0722.00201;ESCO.0722.00201.0050;ESCO.0722.00201.0050b_04578;2;118;116
ESCO.0722.00201;ESCO.0722.00201.0146;ESCO.0722.00201.0146b_04930;277;564;287
ESCO.0722.00201;ESCO.0722.00201.0180;ESCO.0722.00201.0180b_04962;3;323;320
ESCO.0722.00201;ESCO.0722.00201.0249;ESCO.0722.00201.0249b_05026;2;214;212
ESCO.0722.00201;ESCO.0722.00201.0288;ESCO.0722.00201.0288b_05058;2;130;128
ESCO.0722.00201;ESCO.0722.00201.0005;ESCO.0722.00201.0005i_01091;30517;30804;287
ESCO.0722.00201;ESCO.0722.00201.0338;ESCO.0722.00201.0338b_05091;1;72;71
ESCO.0722.00201;ESCO.0722.00201.0029;ESCO.0722.00201.0029i_03661;2490;3344;854
ESCO.0722.00201;ESCO.0722.00201.0129;ESCO.0722.00201.0129b_04909;724;783;59
ESCO.0722.00201;ESCO.0722.00201.0158;ESCO.0722.00201.0158b_04941;1;414;413
ESCO.0722.00201;ESCO.0722.00201.0029;ESCO.0722.00201.0029i_03662;3341;3562;221
ESCO.0722.00201;ESCO.0722.00201.0096;ESCO.0722.00201.0096b_04846;1230;1685;455
ESCO.0722.00201;ESCO.0722.00201.0112;ESCO.0722.00201.0112b_04878;3;1100;1097
ESCO.0722.00201;ESCO.0722.00201.0009;ESCO.0722.00201.0009i_01276;62443;64203;1760
ESCO.0722.00201;ESCO.0722.00201.0029;ESCO.0722.00201.0029i_03708;36946;37146;200
ESCO.0722.00201;ESCO.0722.00201.0029;ESCO.0722.00201.0029i_03740;66951;67463;512
ESCO.0722.00201;ESCO.0722.00201.0103;ESCO.0722.00201.0103b_04860;2;67;65
ESCO.0722.00201;ESCO.0722.00201.0173;ESCO.0722.00201.0173b_04956;1;318;317
ESCO.0722.00201;ESCO.0722.00201.0208;ESCO.0722.00201.0208b_04988;1;267;266
ESCO.0722.00201;ESCO.0722.00201.0240;ESCO.0722.00201.0240b_05020;61;225;164
ESCO.0722.00201;ESCO.0722.00201.0029;ESCO.0722.00201.0029i_03709;37239;38312;1073
ESCO.0722.00201;ESCO.0722.00201.0029;ESCO.0722.00201.0029i_03741;67549;70920;3371
ESCO.0722.00201;ESCO.0722.00201.0029;ESCO.0722.00201.0029i_03773;101037;101240;203
ESCO.0722.00201;ESCO.0722.00201.0039;ESCO.0722.00201.0039i_04381;28617;28814;197
ESCO.0722.00201;ESCO.0722.00201.0142;ESCO.0722.00201.0142b_04925;512;640;128
ESCO.0722.00201;ESCO.0722.00201.0330;ESCO.0722.00201.0330b_05085;2;82;80
ESCO.0722.00201;ESCO.0722.00201.0039;ESCO.0722.00201.0039i_04382;28816;29445;629
ESCO.0722.00201;ESCO.0722.00201.0282;ESCO.0722.00201.0282b_05054;1;138;137
ESCO.0722.00201;ESCO.0722.00201.0126;ESCO.0722.00201.0126b_04903;2;127;125
ESCO.0722.00201;ESCO.0722.00201.0254;ESCO.0722.00201.0254b_05031;1;207;206
ESCO.0722.00201;ESCO.0722.00201.0029;ESCO.0722.00201.0029i_03720;50680;52593;1913
ESCO.0722.00201;ESCO.0722.00201.0029;ESCO.0722.00201.0029b_03784;107334;108005;671
ESCO.0722.00201;ESCO.0722.00201.0035;ESCO.0722.00201.0035b_04168;50275;50718;443
ESCO.0722.00201;ESCO.0722.00201.0062;ESCO.0722.00201.0062b_04712;5867;7000;1133
ESCO.0722.00201;ESCO.0722.00201.0255;ESCO.0722.00201.0255b_05032;2;208;206
ESCO.0722.00201;ESCO.0722.00201.0029;ESCO.0722.00201.0029i_03721;52713;53273;560
ESCO.0722.00201;ESCO.0722.00201.0109;ESCO.0722.00201.0109b_04873;3;152;149
ESCO.0722.00201;ESCO.0722.00201.0153;ESCO.0722.00201.0153b_04937;2;466;464
ESCO.0722.00201;ESCO.0722.00201.0187;ESCO.0722.00201.0187b_04969;3;308;305
ESCO.0722.00201;ESCO.0722.00201.0256;ESCO.0722.00201.0256b_05033;2;205;203
ESCO.0722.00201;ESCO.0722.00201.0079;ESCO.0722.00201.0079b_04792;3;74;71
ESCO.0722.00201;ESCO.0722.00201.0117;ESCO.0722.00201.0117b_04888;3;149;146
ESCO.0722.00201;ESCO.0722.00201.0235;ESCO.0722.00201.0235b_05016;1;135;134
ESCO.0722.00201;ESCO.0722.00201.0199;ESCO.0722.00201.0199b_04981;3;287;284
ESCO.0722.00201;ESCO.0722.00201.0016;ESCO.0722.00201.0016i_02646;38938;39252;314
ESCO.0722.00201;ESCO.0722.00201.0023;ESCO.0722.00201.0023i_03190;141861;142478;617
ESCO.0722.00201;ESCO.0722.00201.0029;ESCO.0722.00201.0029i_03670;6405;6947;542
ESCO.0722.00201;ESCO.0722.00201.0077;ESCO.0722.00201.0077b_04790;256;1395;1139
ESCO.0722.00201;ESCO.0722.00201.0099;ESCO.0722.00201.0099b_04854;1228;1437;209
ESCO.0722.00201;ESCO.0722.00201.0137;ESCO.0722.00201.0137b_04918;1;666;665
ESCO.0722.00201;ESCO.0722.00201.0233;ESCO.0722.00201.0233b_05014;69;236;167
ESCO.0722.00201;ESCO.0722.00201.0318;ESCO.0722.00201.0318b_05078;2;97;95
ESCO.0722.00201;ESCO.0722.00201.0023;ESCO.0722.00201.0023i_03191;142602;143162;560
ESCO.0722.00201;ESCO.0722.00201.0061;ESCO.0722.00201.0061i_04695;716;946;230
ESCO.0722.00201;ESCO.0722.00201.0078;ESCO.0722.00201.0078b_04791;3;1250;1247
ESCO.0722.00201;ESCO.0722.00201.0202;ESCO.0722.00201.0202b_04983;3;281;278
ESCO.0722.00201;ESCO.0722.00201.0269;ESCO.0722.00201.0269b_05047;2;154;152
ESCO.0722.00215;ESCO.0722.00215.0013;ESCO.0722.00215.0013i_02191;85413;86141;728
ESCO.0722.00215;ESCO.0722.00215.0013;ESCO.0722.00215.0013i_02255;149443;149766;323
ESCO.0722.00215;ESCO.0722.00215.0132;ESCO.0722.00215.0132b_04559;3;167;164
ESCO.0722.00215;ESCO.0722.00215.0013;ESCO.0722.00215.0013i_02192;86095;86664;569
ESCO.0722.00215;ESCO.0722.00215.0002;ESCO.0722.00215.0002b_00415;117848;118414;566
ESCO.0722.00215;ESCO.0722.00215.0030;ESCO.0722.00215.0030b_03551;137;733;596
ESCO.0722.00215;ESCO.0722.00215.0032;ESCO.0722.00215.0032i_03711;42072;42266;194
ESCO.0722.00215;ESCO.0722.00215.0040;ESCO.0722.00215.0040b_04031;35621;35959;338
ESCO.0722.00215;ESCO.0722.00215.0071;ESCO.0722.00215.0071b_04479;2;160;158
ESCO.0722.00215;ESCO.0722.00215.0153;ESCO.0722.00215.0153b_04575;33;212;179
ESCO.0722.00215;ESCO.0722.00215.0003;ESCO.0722.00215.0003b_00416;3;467;464
ESCO.0722.00215;ESCO.0722.00215.0019;ESCO.0722.00215.0019i_02880;26101;26958;857
ESCO.0722.00215;ESCO.0722.00215.0032;ESCO.0722.00215.0032i_03712;42232;42447;215
ESCO.0722.00215;ESCO.0722.00215.0071;ESCO.0722.00215.0071i_04480;191;505;314
ESCO.0722.00215;ESCO.0722.00215.0116;ESCO.0722.00215.0116b_04544;2;361;359
ESCO.0722.00215;ESCO.0722.00215.0154;ESCO.0722.00215.0154b_04576;2;208;206
ESCO.0722.00215;ESCO.0722.00215.0012;ESCO.0722.00215.0012i_02113;161901;162911;1010
ESCO.0722.00215;ESCO.0722.00215.0019;ESCO.0722.00215.0019i_02881;27052;27258;206
ESCO.0722.00215;ESCO.0722.00215.0021;ESCO.0722.00215.0021i_03041;22677;24428;1751
ESCO.0722.00215;ESCO.0722.00215.0032;ESCO.0722.00215.0032i_03713;42447;43475;1028
ESCO.0722.00215;ESCO.0722.00215.0071;ESCO.0722.00215.0071i_04481;984;1415;431
ESCO.0722.00215;ESCO.0722.00215.0155;ESCO.0722.00215.0155b_04577;1;105;104
ESCO.0722.00215;ESCO.0722.00215.0009;ESCO.0722.00215.0009i_01556;104068;105507;1439
ESCO.0722.00215;ESCO.0722.00215.0032;ESCO.0722.00215.0032i_03700;34726;35790;1064
ESCO.0722.00215;ESCO.0722.00215.0045;ESCO.0722.00215.0045i_04148;5603;6622;1019
ESCO.0722.00215;ESCO.0722.00215.0067;ESCO.0722.00215.0067i_04468;1283;1753;470
ESCO.0722.00215;ESCO.0722.00215.0138;ESCO.0722.00215.0138b_04564;1;261;260
ESCO.0722.00215;ESCO.0722.00215.0012;ESCO.0722.00215.0012i_02069;122018;123493;1475
ESCO.0722.00215;ESCO.0722.00215.0032;ESCO.0722.00215.0032i_03701;35793;36017;224
ESCO.0722.00215;ESCO.0722.00215.0067;ESCO.0722.00215.0067b_04469;1802;2029;227
ESCO.0722.00215;ESCO.0722.00215.0013;ESCO.0722.00215.0013b_02119;1;405;404
ESCO.0722.00215;ESCO.0722.00215.0019;ESCO.0722.00215.0019i_02887;33437;34015;578
ESCO.0722.00215;ESCO.0722.00215.0032;ESCO.0722.00215.0032i_03687;23910;24572;662
ESCO.0722.00215;ESCO.0722.00215.0045;ESCO.0722.00215.0045b_04167;29948;30118;170
ESCO.0722.00215;ESCO.0722.00215.0124;ESCO.0722.00215.0124b_04551;1;321;320
ESCO.0722.00215;ESCO.0722.00215.0019;ESCO.0722.00215.0019i_02888;34255;35433;1178
ESCO.0722.00215;ESCO.0722.00215.0026;ESCO.0722.00215.0026i_03368;8419;9051;632
ESCO.0722.00215;ESCO.0722.00215.0032;ESCO.0722.00215.0032i_03688;24895;26274;1379
ESCO.0722.00215;ESCO.0722.00215.0032;ESCO.0722.00215.0032b_03720;51645;51806;161
ESCO.0722.00215;ESCO.0722.00215.0063;ESCO.0722.00215.0063b_04456;1;1266;1265
ESCO.0722.00215;ESCO.0722.00215.0125;ESCO.0722.00215.0125b_04552;3;320;317
ESCO.0722.00215;ESCO.0722.00215.0165;ESCO.0722.00215.0165b_04584;3;137;134
ESCO.0722.00215;ESCO.0722.00215.0018;ESCO.0722.00215.0018i_02857;103016;103603;587
ESCO.0722.00215;ESCO.0722.00215.0019;ESCO.0722.00215.0019i_02889;35447;35821;374
ESCO.0722.00215;ESCO.0722.00215.0026;ESCO.0722.00215.0026i_03369;9171;9419;248
ESCO.0722.00215;ESCO.0722.00215.0032;ESCO.0722.00215.0032i_03657;1824;3317;1493
ESCO.0722.00215;ESCO.0722.00215.0093;ESCO.0722.00215.0093b_04521;2;697;695
ESCO.0722.00215;ESCO.0722.00215.0126;ESCO.0722.00215.0126b_04553;3;317;314
ESCO.0722.00215;ESCO.0722.00215.0167;ESCO.0722.00215.0167b_04585;2;133;131
ESCO.0722.00215;ESCO.0722.00215.0010;ESCO.0722.00215.0010i_01774;155215;155820;605
ESCO.0722.00215;ESCO.0722.00215.0013;ESCO.0722.00215.0013i_02190;84541;85428;887
ESCO.0722.00215;ESCO.0722.00215.0065;ESCO.0722.00215.0065b_04462;1;2946;2945
ESCO.0722.00215;ESCO.0722.00215.0097;ESCO.0722.00215.0097b_04526;1;666;665
ESCO.0722.00215;ESCO.0722.00215.0012;ESCO.0722.00215.0012i_02116;164193;164435;242
ESCO.0722.00215;ESCO.0722.00215.0019;ESCO.0722.00215.0019i_02884;30139;32016;1877
ESCO.0722.00215;ESCO.0722.00215.0026;ESCO.0722.00215.0026i_03364;3844;4260;416
ESCO.0722.00215;ESCO.0722.00215.0159;ESCO.0722.00215.0159b_04580;3;158;155
ESCO.0722.00215;ESCO.0722.00215.0019;ESCO.0722.00215.0019i_02885;32044;32439;395
ESCO.0722.00215;ESCO.0722.00215.0032;ESCO.0722.00215.0032i_03717;46593;47558;965
ESCO.0722.00215;ESCO.0722.00215.0089;ESCO.0722.00215.0089b_04517;2;781;779
ESCO.0722.00215;ESCO.0722.00215.0160;ESCO.0722.00215.0160b_04581;3;155;152
ESCO.0722.00215;ESCO.0722.00215.0012;ESCO.0722.00215.0012b_02118;164839;165408;569
ESCO.0722.00215;ESCO.0722.00215.0019;ESCO.0722.00215.0019i_02886;32555;32971;416
ESCO.0722.00215;ESCO.0722.00215.0026;ESCO.0722.00215.0026i_03366;5871;7391;1520
ESCO.0722.00215;ESCO.0722.00215.0032;ESCO.0722.00215.0032b_03654;1;891;890
ESCO.0722.00215;ESCO.0722.00215.0032;ESCO.0722.00215.0032i_03686;22652;23431;779
ESCO.0722.00215;ESCO.0722.00215.0032;ESCO.0722.00215.0032i_03718;47580;49250;1670
ESCO.0722.00215;ESCO.0722.00215.0090;ESCO.0722.00215.0090b_04518;3;779;776
ESCO.0722.00215;ESCO.0722.00215.0123;ESCO.0722.00215.0123b_04550;3;329;326
ESCO.0722.00215;ESCO.0722.00215.0011;ESCO.0722.00215.0011b_01945;167239;168108;869
ESCO.0722.00215;ESCO.0722.00215.0013;ESCO.0722.00215.0013i_02201;97406;98620;1214
ESCO.0722.00215;ESCO.0722.00215.0032;ESCO.0722.00215.0032i_03705;37452;37676;224
ESCO.0722.00215;ESCO.0722.00215.0013;ESCO.0722.00215.0013i_02202;98620;99897;1277
ESCO.0722.00215;ESCO.0722.00215.0016;ESCO.0722.00215.0016i_02650;123967;126036;2069
ESCO.0722.00215;ESCO.0722.00215.0032;ESCO.0722.00215.0032i_03706;37627;37860;233
ESCO.0722.00215;ESCO.0722.00215.0070;ESCO.0722.00215.0070b_04474;1;804;803
ESCO.0722.00215;ESCO.0722.00215.0110;ESCO.0722.00215.0110b_04538;2;442;440
ESCO.0722.00215;ESCO.0722.00215.0001;ESCO.0722.00215.0001i_00155;161394;161579;185
ESCO.0722.00215;ESCO.0722.00215.0013;ESCO.0722.00215.0013i_02203;99900;103541;3641
ESCO.0722.00215;ESCO.0722.00215.0070;ESCO.0722.00215.0070i_04475;816;1001;185
ESCO.0722.00215;ESCO.0722.00215.0012;ESCO.0722.00215.0012i_02070;123748;125160;1412
ESCO.0722.00215;ESCO.0722.00215.0068;ESCO.0722.00215.0068b_04470;2;817;815
ESCO.0722.00215;ESCO.0722.00215.0106;ESCO.0722.00215.0106b_04534;2;466;464
ESCO.0722.00215;ESCO.0722.00215.0142;ESCO.0722.00215.0142b_04566;3;254;251
ESCO.0722.00215;ESCO.0722.00215.0032;ESCO.0722.00215.0032i_03703;36593;36790;197
ESCO.0722.00215;ESCO.0722.00215.0107;ESCO.0722.00215.0107b_04535;3;464;461
ESCO.0722.00215;ESCO.0722.00215.0144;ESCO.0722.00215.0144b_04567;2;250;248
ESCO.0722.00215;ESCO.0722.00215.0012;ESCO.0722.00215.0012i_02104;152104;153267;1163
ESCO.0722.00215;ESCO.0722.00215.0013;ESCO.0722.00215.0013i_02200;96612;97406;794
ESCO.0722.00215;ESCO.0722.00215.0032;ESCO.0722.00215.0032i_03704;36877;37272;395
ESCO.0722.00215;ESCO.0722.00215.0145;ESCO.0722.00215.0145b_04568;3;242;239
ESCO.0722.00215;ESCO.0722.00215.0019;ESCO.0722.00215.0019i_02882;27593;28792;1199
ESCO.0722.00215;ESCO.0722.00215.0026;ESCO.0722.00215.0026b_03362;685;2022;1337
ESCO.0722.00215;ESCO.0722.00215.0071;ESCO.0722.00215.0071b_04482;1427;2137;710
ESCO.0722.00215;ESCO.0722.00215.0087;ESCO.0722.00215.0087b_04514;3;944;941
ESCO.0722.00215;ESCO.0722.00215.0157;ESCO.0722.00215.0157b_04578;2;184;182
ESCO.0722.00215;ESCO.0722.00215.0019;ESCO.0722.00215.0019i_02883;28792;30138;1346
ESCO.0722.00215;ESCO.0722.00215.0026;ESCO.0722.00215.0026i_03363;2024;3772;1748
ESCO.0722.00215;ESCO.0722.00215.0088;ESCO.0722.00215.0088b_04515;2;595;593
ESCO.0722.00215;ESCO.0722.00215.0120;ESCO.0722.00215.0120b_04547;1;336;335
ESCO.0722.00215;ESCO.0722.00215.0032;ESCO.0722.00215.0032i_03696;32444;32668;224
ESCO.0722.00215;ESCO.0722.00215.0133;ESCO.0722.00215.0133b_04560;2;283;281
ESCO.0722.00215;ESCO.0722.00215.0176;ESCO.0722.00215.0176b_04592;2;94;92
ESCO.0722.00215;ESCO.0722.00215.0005;ESCO.0722.00215.0005i_00849;29097;29348;251
ESCO.0722.00215;ESCO.0722.00215.0005;ESCO.0722.00215.0005i_01041;226180;226317;137
ESCO.0722.00215;ESCO.0722.00215.0007;ESCO.0722.00215.0007b_01265;59;319;260
ESCO.0722.00215;ESCO.0722.00215.0013;ESCO.0722.00215.0013i_02193;86661;87374;713
ESCO.0722.00215;ESCO.0722.00215.0032;ESCO.0722.00215.0032i_03697;32665;32898;233
ESCO.0722.00215;ESCO.0722.00215.0005;ESCO.0722.00215.0005i_00850;29335;29655;320
ESCO.0722.00215;ESCO.0722.00215.0013;ESCO.0722.00215.0013i_02194;87377;88573;1196
ESCO.0722.00215;ESCO.0722.00215.0032;ESCO.0722.00215.0032i_03698;32898;33299;401
ESCO.0722.00215;ESCO.0722.00215.0067;ESCO.0722.00215.0067i_04466;619;786;167
ESCO.0722.00215;ESCO.0722.00215.0076;ESCO.0722.00215.0076b_04498;813;1628;815
ESCO.0722.00215;ESCO.0722.00215.0181;ESCO.0722.00215.0181b_04594;2;73;71
ESCO.0722.00215;ESCO.0722.00215.0009;ESCO.0722.00215.0009i_01555;103321;104052;731
ESCO.0722.00215;ESCO.0722.00215.0032;ESCO.0722.00215.0032i_03667;8903;9310;407
ESCO.0722.00215;ESCO.0722.00215.0032;ESCO.0722.00215.0032i_03699;33338;34729;1391
ESCO.0722.00215;ESCO.0722.00215.0045;ESCO.0722.00215.0045i_04147;5024;5602;578
ESCO.0722.00215;ESCO.0722.00215.0067;ESCO.0722.00215.0067i_04467;869;1102;233
ESCO.0722.00215;ESCO.0722.00215.0077;ESCO.0722.00215.0077b_04499;2;703;701
ESCO.0722.00215;ESCO.0722.00215.0029;ESCO.0722.00215.0029i_03548;53951;54220;269
ESCO.0722.00215;ESCO.0722.00215.0032;ESCO.0722.00215.0032i_03676;17195;17665;470
ESCO.0722.00215;ESCO.0722.00215.0040;ESCO.0722.00215.0040i_04028;32923;33237;314
ESCO.0722.00215;ESCO.0722.00215.0070;ESCO.0722.00215.0070i_04476;1001;1210;209
ESCO.0722.00215;ESCO.0722.00215.0112;ESCO.0722.00215.0112b_04540;2;421;419
ESCO.0722.00215;ESCO.0722.00215.0021;ESCO.0722.00215.0021i_03037;17369;17560;191
ESCO.0722.00215;ESCO.0722.00215.0032;ESCO.0722.00215.0032i_03677;17739;17987;248
ESCO.0722.00215;ESCO.0722.00215.0151;ESCO.0722.00215.0151b_04573;3;221;218
ESCO.0722.00215;ESCO.0722.00215.0021;ESCO.0722.00215.0021i_03038;17600;18568;968
ESCO.0722.00215;ESCO.0722.00215.0029;ESCO.0722.00215.0029b_03550;54628;55785;1157
ESCO.0722.00215;ESCO.0722.00215.0152;ESCO.0722.00215.0152b_04574;3;215;212
ESCO.0722.00215;ESCO.0722.00215.0013;ESCO.0722.00215.0013i_02189;83340;84551;1211
ESCO.0722.00215;ESCO.0722.00215.0074;ESCO.0722.00215.0074b_04493;1358;2032;674
ESCO.0722.00215;ESCO.0722.00215.0096;ESCO.0722.00215.0096b_04525;2;679;677
ESCO.0722.00215;ESCO.0722.00215.0018;ESCO.0722.00215.0018b_02858;103606;104010;404
ESCO.0722.00215;ESCO.0722.00215.0019;ESCO.0722.00215.0019i_02890;36025;38910;2885
ESCO.0722.00215;ESCO.0722.00215.0023;ESCO.0722.00215.0023b_03178;3;851;848
ESCO.0722.00215;ESCO.0722.00215.0027;ESCO.0722.00215.0027b_03434;61;492;431
ESCO.0722.00215;ESCO.0722.00215.0032;ESCO.0722.00215.0032i_03658;3323;3556;233
ESCO.0722.00215;ESCO.0722.00215.0032;ESCO.0722.00215.0032i_03690;27487;28722;1235
ESCO.0722.00215;ESCO.0722.00215.0074;ESCO.0722.00215.0074b_04490;213;473;260
ESCO.0722.00215;ESCO.0722.00215.0019;ESCO.0722.00215.0019i_02891;39160;40377;1217
ESCO.0722.00215;ESCO.0722.00215.0032;ESCO.0722.00215.0032i_03659;3562;4515;953
ESCO.0722.00215;ESCO.0722.00215.0032;ESCO.0722.00215.0032i_03691;28854;29414;560
ESCO.0722.00215;ESCO.0722.00215.0074;ESCO.0722.00215.0074i_04491;527;619;92
ESCO.0722.00215;ESCO.0722.00215.0013;ESCO.0722.00215.0013i_02188;82005;83336;1331
ESCO.0722.00215;ESCO.0722.00215.0074;ESCO.0722.00215.0074i_04492;811;1344;533
ESCO.0722.00230;ESCO.0722.00230.0036;ESCO.0722.00230.0036i_03773;82030;82863;833
ESCO.0722.00230;ESCO.0722.00230.0046;ESCO.0722.00230.0046i_04285;21027;21911;884
ESCO.0722.00230;ESCO.0722.00230.0053;ESCO.0722.00230.0053i_04509;4698;4826;128
ESCO.0722.00230;ESCO.0722.00230.0064;ESCO.0722.00230.0064i_04669;2502;3767;1265
ESCO.0722.00230;ESCO.0722.00230.0081;ESCO.0722.00230.0081i_04733;2355;2534;179
ESCO.0722.00230;ESCO.0722.00230.0093;ESCO.0722.00230.0093b_04765;3;143;140
ESCO.0722.00230;ESCO.0722.00230.0134;ESCO.0722.00230.0134b_04829;1;111;110
ESCO.0722.00230;ESCO.0722.00230.0193;ESCO.0722.00230.0193b_04893;3;260;257
ESCO.0722.00230;ESCO.0722.00230.0308;ESCO.0722.00230.0308b_04957;1;66;65
ESCO.0722.00230;ESCO.0722.00230.0019;ESCO.0722.00230.0019i_02317;178508;179920;1412
ESCO.0722.00230;ESCO.0722.00230.0062;ESCO.0722.00230.0062b_04653;6359;6775;416
ESCO.0722.00230;ESCO.0722.00230.0210;ESCO.0722.00230.0210b_04909;2;247;245
ESCO.0722.00230;ESCO.0722.00230.0251;ESCO.0722.00230.0251b_04941;3;110;107
ESCO.0722.00230;ESCO.0722.00230.0046;ESCO.0722.00230.0046i_04270;3711;4289;578
ESCO.0722.00230;ESCO.0722.00230.0046;ESCO.0722.00230.0046i_04302;31509;31691;182
ESCO.0722.00230;ESCO.0722.00230.0211;ESCO.0722.00230.0211b_04910;50;244;194
ESCO.0722.00230;ESCO.0722.00230.0252;ESCO.0722.00230.0252b_04942;3;92;89
ESCO.0722.00230;ESCO.0722.00230.0046;ESCO.0722.00230.0046i_04290;24130;24843;713
ESCO.0722.00230;ESCO.0722.00230.0053;ESCO.0722.00230.0053i_04514;6698;7267;569
ESCO.0722.00230;ESCO.0722.00230.0095;ESCO.0722.00230.0095b_04770;2;295;293
ESCO.0722.00230;ESCO.0722.00230.0113;ESCO.0722.00230.0113b_04802;499;825;326
ESCO.0722.00230;ESCO.0722.00230.0136;ESCO.0722.00230.0136b_04834;233;511;278
ESCO.0722.00230;ESCO.0722.00230.0237;ESCO.0722.00230.0237b_04930;2;220;218
ESCO.0722.00230;ESCO.0722.00230.0019;ESCO.0722.00230.0019i_02339;195704;196210;506
ESCO.0722.00230;ESCO.0722.00230.0036;ESCO.0722.00230.0036i_03779;84973;85521;548
ESCO.0722.00230;ESCO.0722.00230.0046;ESCO.0722.00230.0046i_04291;24861;27461;2600
ESCO.0722.00230;ESCO.0722.00230.0095;ESCO.0722.00230.0095b_04771;379;1164;785
ESCO.0722.00230;ESCO.0722.00230.0114;ESCO.0722.00230.0114b_04803;1;804;803
ESCO.0722.00230;ESCO.0722.00230.0199;ESCO.0722.00230.0199b_04899;1;261;260
ESCO.0722.00230;ESCO.0722.00230.0238;ESCO.0722.00230.0238b_04931;66;218;152
ESCO.0722.00230;ESCO.0722.00230.0004;ESCO.0722.00230.0004i_00405;72809;73504;695
ESCO.0722.00230;ESCO.0722.00230.0046;ESCO.0722.00230.0046i_04277;11393;11812;419
ESCO.0722.00230;ESCO.0722.00230.0071;ESCO.0722.00230.0071i_04693;2741;3172;431
ESCO.0722.00230;ESCO.0722.00230.0079;ESCO.0722.00230.0079i_04725;2281;2760;479
ESCO.0722.00230;ESCO.0722.00230.0034;ESCO.0722.00230.0034i_03574;35932;37452;1520
ESCO.0722.00230;ESCO.0722.00230.0046;ESCO.0722.00230.0046i_04278;12314;12730;416
ESCO.0722.00230;ESCO.0722.00230.0053;ESCO.0722.00230.0053b_04502;1;759;758
ESCO.0722.00230;ESCO.0722.00230.0071;ESCO.0722.00230.0071i_04694;3281;3718;437
ESCO.0722.00230;ESCO.0722.00230.0222;ESCO.0722.00230.0222b_04918;99;233;134
ESCO.0722.00230;ESCO.0722.00230.0034;ESCO.0722.00230.0034i_03575;37454;37627;173
ESCO.0722.00230;ESCO.0722.00230.0046;ESCO.0722.00230.0046i_04279;12732;14261;1529
ESCO.0722.00230;ESCO.0722.00230.0053;ESCO.0722.00230.0053i_04503;768;1523;755
ESCO.0722.00230;ESCO.0722.00230.0064;ESCO.0722.00230.0064b_04663;3;296;293
ESCO.0722.00230;ESCO.0722.00230.0186;ESCO.0722.00230.0186b_04887;1;282;281
ESCO.0722.00230;ESCO.0722.00230.0046;ESCO.0722.00230.0046i_04284;19867;21027;1160
ESCO.0722.00230;ESCO.0722.00230.0053;ESCO.0722.00230.0053i_04508;3514;4296;782
ESCO.0722.00230;ESCO.0722.00230.0056;ESCO.0722.00230.0056b_04572;3;584;581
ESCO.0722.00230;ESCO.0722.00230.0064;ESCO.0722.00230.0064i_04668;2074;2514;440
ESCO.0722.00230;ESCO.0722.00230.0081;ESCO.0722.00230.0081i_04732;1171;1863;692
ESCO.0722.00230;ESCO.0722.00230.0229;ESCO.0722.00230.0229b_04924;1;180;179
ESCO.0722.00230;ESCO.0722.00230.0020;ESCO.0722.00230.0020i_02482;141655;141939;284
ESCO.0722.00230;ESCO.0722.00230.0046;ESCO.0722.00230.0046i_04274;9772;10116;344
ESCO.0722.00230;ESCO.0722.00230.0046;ESCO.0722.00230.0046i_04306;36136;37389;1253
ESCO.0722.00230;ESCO.0722.00230.0103;ESCO.0722.00230.0103b_04786;745;927;182
ESCO.0722.00230;ESCO.0722.00230.0150;ESCO.0722.00230.0150b_04850;2;382;380
ESCO.0722.00230;ESCO.0722.00230.0182;ESCO.0722.00230.0182b_04882;3;137;134
ESCO.0722.00230;ESCO.0722.00230.0218;ESCO.0722.00230.0218b_04914;2;79;77
ESCO.0722.00230;ESCO.0722.00230.0004;ESCO.0722.00230.0004i_00403;70916;71209;293
ESCO.0722.00230;ESCO.0722.00230.0021;ESCO.0722.00230.0021i_02675;128819;129067;248
ESCO.0722.00230;ESCO.0722.00230.0046;ESCO.0722.00230.0046i_04275;10298;10666;368
ESCO.0722.00230;ESCO.0722.00230.0053;ESCO.0722.00230.0053i_04531;19918;20238;320
ESCO.0722.00230;ESCO.0722.00230.0151;ESCO.0722.00230.0151b_04851;1;369;368
ESCO.0722.00230;ESCO.0722.00230.0182;ESCO.0722.00230.0182b_04883;125;289;164
ESCO.0722.00230;ESCO.0722.00230.0219;ESCO.0722.00230.0219b_04915;3;236;233
ESCO.0722.00230;ESCO.0722.00230.0261;ESCO.0722.00230.0261b_04947;1;147;146
ESCO.0722.00230;ESCO.0722.00230.0021;ESCO.0722.00230.0021i_02676;129185;130075;890
ESCO.0722.00230;ESCO.0722.00230.0046;ESCO.0722.00230.0046i_04276;10668;11384;716
ESCO.0722.00230;ESCO.0722.00230.0071;ESCO.0722.00230.0071i_04692;2548;2679;131
ESCO.0722.00230;ESCO.0722.00230.0079;ESCO.0722.00230.0079i_04724;1584;2069;485
ESCO.0722.00230;ESCO.0722.00230.0089;ESCO.0722.00230.0089b_04756;880;1881;1001
ESCO.0722.00230;ESCO.0722.00230.0105;ESCO.0722.00230.0105b_04788;2;883;881
ESCO.0722.00230;ESCO.0722.00230.0220;ESCO.0722.00230.0220b_04916;3;236;233
ESCO.0722.00230;ESCO.0722.00230.0019;ESCO.0722.00230.0019i_02311;173637;175073;1436
ESCO.0722.00230;ESCO.0722.00230.0019;ESCO.0722.00230.0019i_02343;197292;197648;356
ESCO.0722.00230;ESCO.0722.00230.0027;ESCO.0722.00230.0027i_03079;34175;34381;206
ESCO.0722.00230;ESCO.0722.00230.0243;ESCO.0722.00230.0243b_04935;1;213;212
ESCO.0722.00230;ESCO.0722.00230.0036;ESCO.0722.00230.0036b_03784;87145;87279;134
ESCO.0722.00230;ESCO.0722.00230.0053;ESCO.0722.00230.0053i_04520;10875;10967;92
ESCO.0722.00230;ESCO.0722.00230.0076;ESCO.0722.00230.0076b_04712;1034;1381;347
ESCO.0722.00230;ESCO.0722.00230.0086;ESCO.0722.00230.0086b_04744;405;512;107
ESCO.0722.00230;ESCO.0722.00230.0098;ESCO.0722.00230.0098b_04776;92;1159;1067
ESCO.0722.00230;ESCO.0722.00230.0244;ESCO.0722.00230.0244b_04936;1;186;185
ESCO.0722.00230;ESCO.0722.00230.0086;ESCO.0722.00230.0086i_04745;990;1322;332
ESCO.0722.00230;ESCO.0722.00230.0206;ESCO.0722.00230.0206b_04905;2;250;248
ESCO.0722.00230;ESCO.0722.00230.0246;ESCO.0722.00230.0246b_04937;1;210;209
ESCO.0722.00230;ESCO.0722.00230.0019;ESCO.0722.00230.0019i_02308;172663;173124;461
ESCO.0722.00230;ESCO.0722.00230.0019;ESCO.0722.00230.0019i_02340;196173;196358;185
ESCO.0722.00230;ESCO.0722.00230.0036;ESCO.0722.00230.0036i_03780;85530;86045;515
ESCO.0722.00230;ESCO.0722.00230.0046;ESCO.0722.00230.0046i_04292;27461;27778;317
ESCO.0722.00230;ESCO.0722.00230.0062;ESCO.0722.00230.0062b_04644;3;71;68
ESCO.0722.00230;ESCO.0722.00230.0115;ESCO.0722.00230.0115b_04804;97;606;509
ESCO.0722.00230;ESCO.0722.00230.0239;ESCO.0722.00230.0239b_04932;1;150;149
ESCO.0722.00230;ESCO.0722.00230.0019;ESCO.0722.00230.0019i_02309;173363;173476;113
ESCO.0722.00230;ESCO.0722.00230.0046;ESCO.0722.00230.0046i_04293;27828;28121;293
ESCO.0722.00230;ESCO.0722.00230.0053;ESCO.0722.00230.0053i_04517;9892;10347;455
ESCO.0722.00230;ESCO.0722.00230.0115;ESCO.0722.00230.0115b_04805;651;800;149
ESCO.0722.00230;ESCO.0722.00230.0168;ESCO.0722.00230.0168b_04869;3;332;329
ESCO.0722.00230;ESCO.0722.00230.0240;ESCO.0722.00230.0240b_04933;1;216;215
ESCO.0722.00230;ESCO.0722.00230.0019;ESCO.0722.00230.0019i_02310;173439;173624;185
ESCO.0722.00230;ESCO.0722.00230.0053;ESCO.0722.00230.0053i_04518;10419;10634;215
ESCO.0722.00230;ESCO.0722.00230.0076;ESCO.0722.00230.0076b_04710;3;500;497
ESCO.0722.00230;ESCO.0722.00230.0169;ESCO.0722.00230.0169b_04870;2;328;326
ESCO.0722.00230;ESCO.0722.00230.0242;ESCO.0722.00230.0242b_04934;1;213;212
ESCO.0722.00230;ESCO.0722.00230.0038;ESCO.0722.00230.0038i_03855;4727;9958;5231
ESCO.0722.00230;ESCO.0722.00230.0046;ESCO.0722.00230.0046i_04271;4402;5787;1385
ESCO.0722.00230;ESCO.0722.00230.0046;ESCO.0722.00230.0046i_04303;31991;32560;569
ESCO.0722.00230;ESCO.0722.00230.0147;ESCO.0722.00230.0147b_04847;2;250;248
ESCO.0722.00230;ESCO.0722.00230.0215;ESCO.0722.00230.0215b_04911;3;242;239
ESCO.0722.00230;ESCO.0722.00230.0046;ESCO.0722.00230.0046i_04272;5803;7863;2060
ESCO.0722.00230;ESCO.0722.00230.0046;ESCO.0722.00230.0046i_04304;32557;32670;113
ESCO.0722.00230;ESCO.0722.00230.0071;ESCO.0722.00230.0071b_04688;3;260;257
ESCO.0722.00230;ESCO.0722.00230.0103;ESCO.0722.00230.0103b_04784;1;396;395
ESCO.0722.00230;ESCO.0722.00230.0019;ESCO.0722.00230.0019b_02353;203339;203665;326
ESCO.0722.00230;ESCO.0722.00230.0034;ESCO.0722.00230.0034i_03569;32044;32241;197
ESCO.0722.00230;ESCO.0722.00230.0046;ESCO.0722.00230.0046i_04273;8098;9108;1010
ESCO.0722.00230;ESCO.0722.00230.0046;ESCO.0722.00230.0046i_04305;32892;36014;3122
ESCO.0722.00230;ESCO.0722.00230.0063;ESCO.0722.00230.0063i_04657;2520;3143;623
ESCO.0722.00230;ESCO.0722.00230.0124;ESCO.0722.00230.0124b_04817;3;245;242
ESCO.0722.00230;ESCO.0722.00230.0148;ESCO.0722.00230.0148b_04849;327;398;71
ESCO.0722.00230;ESCO.0722.00230.0027;ESCO.0722.00230.0027i_03070;29565;30113;548
ESCO.0722.00230;ESCO.0722.00230.0036;ESCO.0722.00230.0036i_03774;82866;83057;191
ESCO.0722.00230;ESCO.0722.00230.0046;ESCO.0722.00230.0046i_04286;21922;22620;698
ESCO.0722.00230;ESCO.0722.00230.0053;ESCO.0722.00230.0053i_04510;4842;5006;164
ESCO.0722.00230;ESCO.0722.00230.0064;ESCO.0722.00230.0064i_04670;3918;4709;791
ESCO.0722.00230;ESCO.0722.00230.0081;ESCO.0722.00230.0081i_04734;2587;2865;278
ESCO.0722.00230;ESCO.0722.00230.0232;ESCO.0722.00230.0232b_04926;165;224;59
ESCO.0722.00230;ESCO.0722.00230.0036;ESCO.0722.00230.0036i_03775;83059;83874;815
ESCO.0722.00230;ESCO.0722.00230.0046;ESCO.0722.00230.0046i_04287;22610;22756;146
ESCO.0722.00230;ESCO.0722.00230.0053;ESCO.0722.00230.0053i_04511;5263;5862;599
ESCO.0722.00230;ESCO.0722.00230.0064;ESCO.0722.00230.0064i_04671;4724;5065;341
ESCO.0722.00230;ESCO.0722.00230.0134;ESCO.0722.00230.0134b_04831;398;547;149
ESCO.0722.00230;ESCO.0722.00230.0162;ESCO.0722.00230.0162b_04863;2;346;344
ESCO.0722.00230;ESCO.0722.00230.0036;ESCO.0722.00230.0036i_03776;83871;84488;617
ESCO.0722.00230;ESCO.0722.00230.0046;ESCO.0722.00230.0046i_04288;22839;23879;1040
ESCO.0722.00230;ESCO.0722.00230.0053;ESCO.0722.00230.0053i_04512;6002;6316;314
ESCO.0722.00230;ESCO.0722.00230.0064;ESCO.0722.00230.0064b_04672;5625;6344;719
ESCO.0722.00230;ESCO.0722.00230.0082;ESCO.0722.00230.0082b_04736;3;953;950
ESCO.0722.00230;ESCO.0722.00230.0046;ESCO.0722.00230.0046i_04289;23895;24122;227
ESCO.0722.00230;ESCO.0722.00230.0053;ESCO.0722.00230.0053i_04513;6319;6555;236
ESCO.0722.00230;ESCO.0722.00230.0164;ESCO.0722.00230.0164b_04865;3;338;335
ESCO.0722.00230;ESCO.0722.00230.0045;ESCO.0722.00230.0045b_04266;42804;42950;146
ESCO.0722.00230;ESCO.0722.00230.0086;ESCO.0722.00230.0086i_04746;1531;1815;284
ESCO.0722.00230;ESCO.0722.00230.0119;ESCO.0722.00230.0119b_04810;2;730;728
ESCO.0722.00230;ESCO.0722.00230.0247;ESCO.0722.00230.0247b_04938;49;207;158
ESCO.0722.00230;ESCO.0722.00230.0046;ESCO.0722.00230.0046b_04267;103;282;179
ESCO.0722.00230;ESCO.0722.00230.0086;ESCO.0722.00230.0086i_04747;1884;2243;359
ESCO.0722.00230;ESCO.0722.00230.0174;ESCO.0722.00230.0174b_04875;1;321;320
ESCO.0722.00230;ESCO.0722.00230.0249;ESCO.0722.00230.0249b_04939;2;205;203
ESCO.0722.00230;ESCO.0722.00230.0019;ESCO.0722.00230.0019i_02316;176664;178508;1844
ESCO.0722.00230;ESCO.0722.00230.0034;ESCO.0722.00230.0034i_03564;27756;28037;281
ESCO.0722.00230;ESCO.0722.00230.0046;ESCO.0722.00230.0046i_04268;337;570;233
ESCO.0722.00230;ESCO.0722.00230.0086;ESCO.0722.00230.0086b_04748;2240;2536;296
ESCO.0722.00230;ESCO.0722.00230.0209;ESCO.0722.00230.0209b_04908;2;247;245
ESCO.0722.00230;ESCO.0722.00230.0250;ESCO.0722.00230.0250b_04940;1;204;203
ESCO.0722.00230;ESCO.0722.00230.0019;ESCO.0722.00230.0019i_02331;191233;191910;677
ESCO.0722.00230;ESCO.0722.00230.0027;ESCO.0722.00230.0027i_03067;28169;28735;566
ESCO.0722.00230;ESCO.0722.00230.0046;ESCO.0722.00230.0046i_04283;18830;19825;995
ESCO.0722.00230;ESCO.0722.00230.0064;ESCO.0722.00230.0064i_04667;1234;1659;425
ESCO.0722.00230;ESCO.0722.00230.0132;ESCO.0722.00230.0132b_04827;3;599;596
ESCO.0722.00230;ESCO.0722.00230.0227;ESCO.0722.00230.0227b_04923;7;228;221
ESCO.0722.00230;ESCO.0722.00230.0034;ESCO.0722.00230.0034i_03576;37672;38859;1187
ESCO.0722.00230;ESCO.0722.00230.0046;ESCO.0722.00230.0046i_04280;14261;17497;3236
ESCO.0722.00230;ESCO.0722.00230.0053;ESCO.0722.00230.0053i_04504;1560;2033;473
ESCO.0722.00230;ESCO.0722.00230.0053;ESCO.0722.00230.0053b_04536;23108;24139;1031
ESCO.0722.00230;ESCO.0722.00230.0064;ESCO.0722.00230.0064i_04664;296;451;155
ESCO.0722.00230;ESCO.0722.00230.0091;ESCO.0722.00230.0091b_04760;3;185;182
ESCO.0722.00230;ESCO.0722.00230.0130;ESCO.0722.00230.0130b_04824;2;610;608
ESCO.0722.00230;ESCO.0722.00230.0224;ESCO.0722.00230.0224b_04920;1;231;230
ESCO.0722.00230;ESCO.0722.00230.0046;ESCO.0722.00230.0046i_04281;17497;18123;626
ESCO.0722.00230;ESCO.0722.00230.0053;ESCO.0722.00230.0053i_04505;2094;2435;341
ESCO.0722.00230;ESCO.0722.00230.0064;ESCO.0722.00230.0064i_04665;523;762;239
ESCO.0722.00230;ESCO.0722.00230.0091;ESCO.0722.00230.0091i_04761;552;1256;704
ESCO.0722.00230;ESCO.0722.00230.0225;ESCO.0722.00230.0225b_04921;162;230;68
ESCO.0722.00230;ESCO.0722.00230.0046;ESCO.0722.00230.0046i_04282;18297;18830;533
ESCO.0722.00230;ESCO.0722.00230.0064;ESCO.0722.00230.0064i_04666;772;1176;404
ESCO.0722.00230;ESCO.0722.00230.0189;ESCO.0722.00230.0189b_04890;2;280;278
ESCO.0722.00256;ESCO.0722.00256.0022;ESCO.0722.00256.0022i_02815;8861;9523;662
ESCO.0722.00256;ESCO.0722.00256.0028;ESCO.0722.00256.0028i_03615;27016;27705;689
ESCO.0722.00256;ESCO.0722.00256.0040;ESCO.0722.00256.0040i_04319;26267;27541;1274
ESCO.0722.00256;ESCO.0722.00256.0051;ESCO.0722.00256.0051i_04607;18357;18569;212
ESCO.0722.00256;ESCO.0722.00256.0194;ESCO.0722.00256.0194b_05055;3;230;227
ESCO.0722.00256;ESCO.0722.00256.0001;ESCO.0722.00256.0001i_00239;268250;268477;227
ESCO.0722.00256;ESCO.0722.00256.0005;ESCO.0722.00256.0005i_00975;238805;239038;233
ESCO.0722.00256;ESCO.0722.00256.0046;ESCO.0722.00256.0046i_04495;23955;24566;611
ESCO.0722.00256;ESCO.0722.00256.0052;ESCO.0722.00256.0052b_04623;8611;10338;1727
ESCO.0722.00256;ESCO.0722.00256.0062;ESCO.0722.00256.0062b_04751;10464;11366;902
ESCO.0722.00256;ESCO.0722.00256.0082;ESCO.0722.00256.0082b_04879;212;1180;968
ESCO.0722.00256;ESCO.0722.00256.0146;ESCO.0722.00256.0146b_05007;29;460;431
ESCO.0722.00256;ESCO.0722.00256.0212;ESCO.0722.00256.0212b_05071;2;205;203
ESCO.0722.00256;ESCO.0722.00256.0001;ESCO.0722.00256.0001i_00016;20321;20965;644
ESCO.0722.00256;ESCO.0722.00256.0020;ESCO.0722.00256.0020i_02640;147443;147865;422
ESCO.0722.00256;ESCO.0722.00256.0046;ESCO.0722.00256.0046i_04496;24563;24976;413
ESCO.0722.00256;ESCO.0722.00256.0053;ESCO.0722.00256.0053b_04624;3;749;746
ESCO.0722.00256;ESCO.0722.00256.0063;ESCO.0722.00256.0063b_04752;2;94;92
ESCO.0722.00256;ESCO.0722.00256.0082;ESCO.0722.00256.0082i_04880;1177;3684;2507
ESCO.0722.00256;ESCO.0722.00256.0119;ESCO.0722.00256.0119b_04976;3;785;782
ESCO.0722.00256;ESCO.0722.00256.0214;ESCO.0722.00256.0214b_05072;86;205;119
ESCO.0722.00256;ESCO.0722.00256.0007;ESCO.0722.00256.0007i_01124;13126;13671;545
ESCO.0722.00256;ESCO.0722.00256.0010;ESCO.0722.00256.0010i_01668;30487;31266;779
ESCO.0722.00256;ESCO.0722.00256.0040;ESCO.0722.00256.0040i_04292;6671;7531;860
ESCO.0722.00256;ESCO.0722.00256.0040;ESCO.0722.00256.0040i_04324;31532;31696;164
ESCO.0722.00256;ESCO.0722.00256.0137;ESCO.0722.00256.0137b_04996;3;545;542
ESCO.0722.00256;ESCO.0722.00256.0170;ESCO.0722.00256.0170b_05028;2;184;182
ESCO.0722.00256;ESCO.0722.00256.0200;ESCO.0722.00256.0200b_05060;143;217;74
ESCO.0722.00256;ESCO.0722.00256.0001;ESCO.0722.00256.0001i_00229;258104;259279;1175
ESCO.0722.00256;ESCO.0722.00256.0027;ESCO.0722.00256.0027b_03589;117572;117778;206
ESCO.0722.00256;ESCO.0722.00256.0040;ESCO.0722.00256.0040i_04293;7535;7642;107
ESCO.0722.00256;ESCO.0722.00256.0040;ESCO.0722.00256.0040i_04325;31877;32035;158
ESCO.0722.00256;ESCO.0722.00256.0202;ESCO.0722.00256.0202b_05061;3;215;212
ESCO.0722.00256;ESCO.0722.00256.0005;ESCO.0722.00256.0005i_00855;117219;117359;140
ESCO.0722.00256;ESCO.0722.00256.0014;ESCO.0722.00256.0014i_01975;37422;38060;638
ESCO.0722.00256;ESCO.0722.00256.0053;ESCO.0722.00256.0053i_04631;3484;3693;209
ESCO.0722.00256;ESCO.0722.00256.0057;ESCO.0722.00256.0057b_04695;12577;13461;884
ESCO.0722.00256;ESCO.0722.00256.0092;ESCO.0722.00256.0092i_04919;984;1952;968
ESCO.0722.00256;ESCO.0722.00256.0155;ESCO.0722.00256.0155b_05015;3;398;395
ESCO.0722.00256;ESCO.0722.00256.0224;ESCO.0722.00256.0224b_05079;2;163;161
ESCO.0722.00256;ESCO.0722.00256.0040;ESCO.0722.00256.0040i_04280;1157;1744;587
ESCO.0722.00256;ESCO.0722.00256.0053;ESCO.0722.00256.0053i_04632;3741;6983;3242
ESCO.0722.00256;ESCO.0722.00256.0058;ESCO.0722.00256.0058b_04696;1;747;746
ESCO.0722.00256;ESCO.0722.00256.0092;ESCO.0722.00256.0092b_04920;2023;2112;89
ESCO.0722.00256;ESCO.0722.00256.0022;ESCO.0722.00256.0022i_02873;56498;56662;164
ESCO.0722.00256;ESCO.0722.00256.0040;ESCO.0722.00256.0040i_04281;1741;2421;680
ESCO.0722.00256;ESCO.0722.00256.0053;ESCO.0722.00256.0053i_04633;6976;7317;341
ESCO.0722.00256;ESCO.0722.00256.0074;ESCO.0722.00256.0074b_04857;3763;5442;1679
ESCO.0722.00256;ESCO.0722.00256.0158;ESCO.0722.00256.0158b_05017;1;360;359
ESCO.0722.00256;ESCO.0722.00256.0006;ESCO.0722.00256.0006b_01108;47060;47911;851
ESCO.0722.00256;ESCO.0722.00256.0053;ESCO.0722.00256.0053i_04628;1872;2216;344
ESCO.0722.00256;ESCO.0722.00256.0073;ESCO.0722.00256.0073b_04852;6004;6219;215
ESCO.0722.00256;ESCO.0722.00256.0007;ESCO.0722.00256.0007b_01109;3;2153;2150
ESCO.0722.00256;ESCO.0722.00256.0014;ESCO.0722.00256.0014i_01973;35964;36275;311
ESCO.0722.00256;ESCO.0722.00256.0040;ESCO.0722.00256.0040b_04277;2;301;299
ESCO.0722.00256;ESCO.0722.00256.0053;ESCO.0722.00256.0053i_04629;2283;2999;716
ESCO.0722.00256;ESCO.0722.00256.0092;ESCO.0722.00256.0092b_04917;3;410;407
ESCO.0722.00256;ESCO.0722.00256.0262;ESCO.0722.00256.0262b_05109;3;98;95
ESCO.0722.00256;ESCO.0722.00256.0014;ESCO.0722.00256.0014i_01974;36285;37265;980
ESCO.0722.00256;ESCO.0722.00256.0040;ESCO.0722.00256.0040i_04278;288;665;377
ESCO.0722.00256;ESCO.0722.00256.0053;ESCO.0722.00256.0053i_04630;3014;3388;374
ESCO.0722.00256;ESCO.0722.00256.0092;ESCO.0722.00256.0092i_04918;441;968;527
ESCO.0722.00256;ESCO.0722.00256.0234;ESCO.0722.00256.0234b_05086;27;137;110
ESCO.0722.00256;ESCO.0722.00256.0001;ESCO.0722.00256.0001i_00233;262347;265034;2687
ESCO.0722.00256;ESCO.0722.00256.0005;ESCO.0722.00256.0005i_00777;38409;38726;317
ESCO.0722.00256;ESCO.0722.00256.0006;ESCO.0722.00256.0006i_01065;11008;11850;842
ESCO.0722.00256;ESCO.0722.00256.0046;ESCO.0722.00256.0046i_04489;18575;19810;1235
ESCO.0722.00256;ESCO.0722.00256.0052;ESCO.0722.00256.0052i_04617;3279;3479;200
ESCO.0722.00256;ESCO.0722.00256.0173;ESCO.0722.00256.0173b_05033;3;110;107
ESCO.0722.00256;ESCO.0722.00256.0205;ESCO.0722.00256.0205b_05065;3;215;212
ESCO.0722.00256;ESCO.0722.00256.0001;ESCO.0722.00256.0001i_00234;265031;265441;410
ESCO.0722.00256;ESCO.0722.00256.0006;ESCO.0722.00256.0006i_01066;11934;12248;314
ESCO.0722.00256;ESCO.0722.00256.0022;ESCO.0722.00256.0022i_02826;14217;15032;815
ESCO.0722.00256;ESCO.0722.00256.0040;ESCO.0722.00256.0040i_04298;10740;11132;392
ESCO.0722.00256;ESCO.0722.00256.0046;ESCO.0722.00256.0046i_04490;19826;20221;395
ESCO.0722.00256;ESCO.0722.00256.0052;ESCO.0722.00256.0052i_04618;3521;3886;365
ESCO.0722.00256;ESCO.0722.00256.0206;ESCO.0722.00256.0206b_05066;2;169;167
ESCO.0722.00256;ESCO.0722.00256.0247;ESCO.0722.00256.0247b_05098;2;115;113
ESCO.0722.00256;ESCO.0722.00256.0001;ESCO.0722.00256.0001i_00235;265434;265670;236
ESCO.0722.00256;ESCO.0722.00256.0006;ESCO.0722.00256.0006i_01067;12253;12471;218
ESCO.0722.00256;ESCO.0722.00256.0022;ESCO.0722.00256.0022i_02827;15034;15444;410
ESCO.0722.00256;ESCO.0722.00256.0052;ESCO.0722.00256.0052i_04619;4177;4740;563
ESCO.0722.00256;ESCO.0722.00256.0087;ESCO.0722.00256.0087b_04907;2929;3270;341
ESCO.0722.00256;ESCO.0722.00256.0207;ESCO.0722.00256.0207b_05067;1;210;209
ESCO.0722.00256;ESCO.0722.00256.0001;ESCO.0722.00256.0001i_00230;259259;260209;950
ESCO.0722.00256;ESCO.0722.00256.0028;ESCO.0722.00256.0028b_03590;29;1087;1058
ESCO.0722.00256;ESCO.0722.00256.0040;ESCO.0722.00256.0040i_04294;7639;9519;1880
ESCO.0722.00256;ESCO.0722.00256.0040;ESCO.0722.00256.0040i_04326;32032;32256;224
ESCO.0722.00256;ESCO.0722.00256.0046;ESCO.0722.00256.0046i_04486;12589;13584;995
ESCO.0722.00256;ESCO.0722.00256.0079;ESCO.0722.00256.0079b_04870;4013;4597;584
ESCO.0722.00256;ESCO.0722.00256.0097;ESCO.0722.00256.0097b_04934;3;257;254
ESCO.0722.00256;ESCO.0722.00256.0112;ESCO.0722.00256.0112b_04966;772;879;107
ESCO.0722.00256;ESCO.0722.00256.0203;ESCO.0722.00256.0203b_05062;2;79;77
ESCO.0722.00256;ESCO.0722.00256.0001;ESCO.0722.00256.0001i_00231;260231;261112;881
ESCO.0722.00256;ESCO.0722.00256.0006;ESCO.0722.00256.0006i_01063;9223;9747;524
ESCO.0722.00256;ESCO.0722.00256.0012;ESCO.0722.00256.0012b_01831;3;275;272
ESCO.0722.00256;ESCO.0722.00256.0040;ESCO.0722.00256.0040b_04327;32319;32954;635
ESCO.0722.00256;ESCO.0722.00256.0046;ESCO.0722.00256.0046i_04487;13590;14618;1028
ESCO.0722.00256;ESCO.0722.00256.0087;ESCO.0722.00256.0087b_04903;35;1159;1124
ESCO.0722.00256;ESCO.0722.00256.0203;ESCO.0722.00256.0203b_05063;125;214;89
ESCO.0722.00256;ESCO.0722.00256.0001;ESCO.0722.00256.0001i_00232;261792;262064;272
ESCO.0722.00256;ESCO.0722.00256.0005;ESCO.0722.00256.0005i_00776;38160;38369;209
ESCO.0722.00256;ESCO.0722.00256.0006;ESCO.0722.00256.0006i_01064;10471;10968;497
ESCO.0722.00256;ESCO.0722.00256.0022;ESCO.0722.00256.0022i_02824;13645;13962;317
ESCO.0722.00256;ESCO.0722.00256.0040;ESCO.0722.00256.0040i_04296;10213;10578;365
ESCO.0722.00256;ESCO.0722.00256.0046;ESCO.0722.00256.0046i_04488;14721;18521;3800
ESCO.0722.00256;ESCO.0722.00256.0052;ESCO.0722.00256.0052i_04616;2865;3080;215
ESCO.0722.00256;ESCO.0722.00256.0140;ESCO.0722.00256.0140b_05000;3;485;482
ESCO.0722.00256;ESCO.0722.00256.0204;ESCO.0722.00256.0204b_05064;1;180;179
ESCO.0722.00256;ESCO.0722.00256.0001;ESCO.0722.00256.0001i_00017;20958;21476;518
ESCO.0722.00256;ESCO.0722.00256.0020;ESCO.0722.00256.0020i_02641;147866;148357;491
ESCO.0722.00256;ESCO.0722.00256.0021;ESCO.0722.00256.0021b_02801;158301;158759;458
ESCO.0722.00256;ESCO.0722.00256.0053;ESCO.0722.00256.0053i_04625;746;1072;326
ESCO.0722.00256;ESCO.0722.00256.0101;ESCO.0722.00256.0101b_04945;3;1535;1532
ESCO.0722.00256;ESCO.0722.00256.0120;ESCO.0722.00256.0120b_04977;1;732;731
ESCO.0722.00256;ESCO.0722.00256.0007;ESCO.0722.00256.0007i_01138;20487;20804;317
ESCO.0722.00256;ESCO.0722.00256.0053;ESCO.0722.00256.0053i_04626;1082;1432;350
ESCO.0722.00256;ESCO.0722.00256.0090;ESCO.0722.00256.0090b_04914;2285;2869;584
ESCO.0722.00256;ESCO.0722.00256.0006;ESCO.0722.00256.0006i_01075;17895;18305;410
ESCO.0722.00256;ESCO.0722.00256.0053;ESCO.0722.00256.0053i_04627;1429;1875;446
ESCO.0722.00256;ESCO.0722.00256.0149;ESCO.0722.00256.0149b_05011;1;444;443
ESCO.0722.00256;ESCO.0722.00256.0003;ESCO.0722.00256.0003i_00544;119523;119750;227
ESCO.0722.00256;ESCO.0722.00256.0028;ESCO.0722.00256.0028i_03616;27705;28370;665
ESCO.0722.00256;ESCO.0722.00256.0236;ESCO.0722.00256.0236b_05088;1;135;134
ESCO.0722.00256;ESCO.0722.00256.0275;ESCO.0722.00256.0275b_05120;2;67;65
ESCO.0722.00256;ESCO.0722.00256.0040;ESCO.0722.00256.0040i_04321;29674;30096;422
ESCO.0722.00256;ESCO.0722.00256.0076;ESCO.0722.00256.0076b_04865;5004;5144;140
ESCO.0722.00256;ESCO.0722.00256.0109;ESCO.0722.00256.0109b_04961;181;1113;932
ESCO.0722.00256;ESCO.0722.00256.0165;ESCO.0722.00256.0165b_05025;2;268;266
ESCO.0722.00256;ESCO.0722.00256.0001;ESCO.0722.00256.0001i_00066;78057;79061;1004
ESCO.0722.00256;ESCO.0722.00256.0040;ESCO.0722.00256.0040i_04322;30224;30772;548
ESCO.0722.00256;ESCO.0722.00256.0277;ESCO.0722.00256.0277b_05122;2;67;65
ESCO.0722.00256;ESCO.0722.00256.0001;ESCO.0722.00256.0001i_00067;79151;79645;494
ESCO.0722.00256;ESCO.0722.00256.0020;ESCO.0722.00256.0020b_02499;152;934;782
ESCO.0722.00256;ESCO.0722.00256.0026;ESCO.0722.00256.0026i_03363;3368;3499;131
ESCO.0722.00256;ESCO.0722.00256.0040;ESCO.0722.00256.0040i_04291;6532;6678;146
ESCO.0722.00256;ESCO.0722.00256.0040;ESCO.0722.00256.0040i_04323;30763;31482;719
ESCO.0722.00256;ESCO.0722.00256.0096;ESCO.0722.00256.0096i_04931;1163;1288;125
ESCO.0722.00256;ESCO.0722.00256.0111;ESCO.0722.00256.0111b_04963;2;973;971
ESCO.0722.00256;ESCO.0722.00256.0198;ESCO.0722.00256.0198b_05059;1;222;221
ESCO.0722.00256;ESCO.0722.00256.0239;ESCO.0722.00256.0239b_05091;2;127;125
ESCO.0722.00256;ESCO.0722.00256.0001;ESCO.0722.00256.0001i_00236;265667;266257;590
ESCO.0722.00256;ESCO.0722.00256.0006;ESCO.0722.00256.0006i_01068;12514;13212;698
ESCO.0722.00256;ESCO.0722.00256.0006;ESCO.0722.00256.0006i_01100;40879;42159;1280
ESCO.0722.00256;ESCO.0722.00256.0027;ESCO.0722.00256.0027i_03564;90568;91839;1271
ESCO.0722.00256;ESCO.0722.00256.0052;ESCO.0722.00256.0052i_04620;4737;6398;1661
ESCO.0722.00256;ESCO.0722.00256.0072;ESCO.0722.00256.0072i_04844;3606;5459;1853
ESCO.0722.00256;ESCO.0722.00256.0088;ESCO.0722.00256.0088b_04908;3;476;473
ESCO.0722.00256;ESCO.0722.00256.0001;ESCO.0722.00256.0001i_00237;266345;267349;1004
ESCO.0722.00256;ESCO.0722.00256.0005;ESCO.0722.00256.0005i_00973;237394;237864;470
ESCO.0722.00256;ESCO.0722.00256.0010;ESCO.0722.00256.0010i_01645;16935;17861;926
ESCO.0722.00256;ESCO.0722.00256.0018;ESCO.0722.00256.0018b_02349;3;1823;1820
ESCO.0722.00256;ESCO.0722.00256.0027;ESCO.0722.00256.0027i_03565;91826;92164;338
ESCO.0722.00256;ESCO.0722.00256.0038;ESCO.0722.00256.0038i_04237;17518;17910;392
ESCO.0722.00256;ESCO.0722.00256.0052;ESCO.0722.00256.0052i_04621;6462;8399;1937
ESCO.0722.00256;ESCO.0722.00256.0056;ESCO.0722.00256.0056i_04685;10298;11041;743
ESCO.0722.00256;ESCO.0722.00256.0072;ESCO.0722.00256.0072i_04845;5462;5995;533
ESCO.0722.00256;ESCO.0722.00256.0178;ESCO.0722.00256.0178b_05037;1;72;71
ESCO.0722.00256;ESCO.0722.00256.0001;ESCO.0722.00256.0001i_00238;267372;268232;860
ESCO.0722.00256;ESCO.0722.00256.0005;ESCO.0722.00256.0005i_00974;237861;238766;905
ESCO.0722.00256;ESCO.0722.00256.0007;ESCO.0722.00256.0007i_01134;18557;18913;356
ESCO.0722.00256;ESCO.0722.00256.0010;ESCO.0722.00256.0010i_01646;17848;18396;548
ESCO.0722.00256;ESCO.0722.00256.0024;ESCO.0722.00256.0024i_03214;112297;112536;239
ESCO.0722.00256;ESCO.0722.00256.0046;ESCO.0722.00256.0046i_04494;23389;23982;593
ESCO.0722.00256;ESCO.0722.00256.0052;ESCO.0722.00256.0052i_04622;8444;8665;221
ESCO.0722.00256;ESCO.0722.00256.0088;ESCO.0722.00256.0088b_04910;2286;2948;662
ESCO.0722.00256;ESCO.0722.00256.0145;ESCO.0722.00256.0145b_05006;152;460;308
ESCO.0722.00256;ESCO.0722.00256.0178;ESCO.0722.00256.0178b_05038;136;270;134
ESCO.0722.00256;ESCO.0722.00256.0251;ESCO.0722.00256.0251b_05102;1;111;110
ESCO.0722.00256;ESCO.0722.00256.0040;ESCO.0722.00256.0040i_04285;3526;3777;251
ESCO.0722.00256;ESCO.0722.00256.0067;ESCO.0722.00256.0067i_04797;623;922;299
ESCO.0722.00256;ESCO.0722.00256.0007;ESCO.0722.00256.0007i_01146;25478;25693;215
ESCO.0722.00256;ESCO.0722.00256.0022;ESCO.0722.00256.0022i_02874;56769;57542;773
ESCO.0722.00256;ESCO.0722.00256.0040;ESCO.0722.00256.0040i_04282;2430;2618;188
ESCO.0722.00256;ESCO.0722.00256.0066;ESCO.0722.00256.0066i_04794;7024;9105;2081
ESCO.0722.00256;ESCO.0722.00256.0075;ESCO.0722.00256.0075b_04858;750;2651;1901
ESCO.0722.00256;ESCO.0722.00256.0040;ESCO.0722.00256.0040i_04283;2615;2854;239
ESCO.0722.00256;ESCO.0722.00256.0054;ESCO.0722.00256.0054b_04635;2;220;218
ESCO.0722.00256;ESCO.0722.00256.0066;ESCO.0722.00256.0066b_04795;9315;9689;374
ESCO.0722.00257;ESCO.0722.00257.0035;ESCO.0722.00257.0035i_03677;988;1362;374
ESCO.0722.00257;ESCO.0722.00257.0046;ESCO.0722.00257.0046i_04157;20071;21270;1199
ESCO.0722.00257;ESCO.0722.00257.0055;ESCO.0722.00257.0055i_04413;10410;10649;239
ESCO.0722.00257;ESCO.0722.00257.0186;ESCO.0722.00257.0186b_04797;2;121;119
ESCO.0722.00257;ESCO.0722.00257.0046;ESCO.0722.00257.0046i_04141;6647;6832;185
ESCO.0722.00257;ESCO.0722.00257.0046;ESCO.0722.00257.0046i_04173;32553;32891;338
ESCO.0722.00257;ESCO.0722.00257.0066;ESCO.0722.00257.0066i_04589;5999;6682;683
ESCO.0722.00257;ESCO.0722.00257.0168;ESCO.0722.00257.0168b_04781;3;299;296
ESCO.0722.00257;ESCO.0722.00257.0261;ESCO.0722.00257.0261b_04845;3;104;101
ESCO.0722.00257;ESCO.0722.00257.0046;ESCO.0722.00257.0046i_04142;6790;7068;278
ESCO.0722.00257;ESCO.0722.00257.0055;ESCO.0722.00257.0055b_04398;2;247;245
ESCO.0722.00257;ESCO.0722.00257.0066;ESCO.0722.00257.0066i_04590;6679;7893;1214
ESCO.0722.00257;ESCO.0722.00257.0210;ESCO.0722.00257.0210b_04814;3;212;209
ESCO.0722.00257;ESCO.0722.00257.0262;ESCO.0722.00257.0262b_04846;2;100;98
ESCO.0722.00257;ESCO.0722.00257.0046;ESCO.0722.00257.0046i_04162;24186;24443;257
ESCO.0722.00257;ESCO.0722.00257.0035;ESCO.0722.00257.0035i_03747;61190;61588;398
ESCO.0722.00257;ESCO.0722.00257.0046;ESCO.0722.00257.0046b_04131;607;1428;821
ESCO.0722.00257;ESCO.0722.00257.0046;ESCO.0722.00257.0046i_04163;24453;25223;770
ESCO.0722.00257;ESCO.0722.00257.0128;ESCO.0722.00257.0128b_04739;3;452;449
ESCO.0722.00257;ESCO.0722.00257.0248;ESCO.0722.00257.0248b_04835;2;115;113
ESCO.0722.00257;ESCO.0722.00257.0056;ESCO.0722.00257.0056i_04437;4959;5954;995
ESCO.0722.00257;ESCO.0722.00257.0082;ESCO.0722.00257.0082b_04661;3354;3428;74
ESCO.0722.00257;ESCO.0722.00257.0056;ESCO.0722.00257.0056i_04438;5997;7931;1934
ESCO.0722.00257;ESCO.0722.00257.0146;ESCO.0722.00257.0146b_04758;2;400;398
ESCO.0722.00257;ESCO.0722.00257.0023;ESCO.0722.00257.0023i_03031;11286;12572;1286
ESCO.0722.00257;ESCO.0722.00257.0046;ESCO.0722.00257.0046i_04151;13826;14284;458
ESCO.0722.00257;ESCO.0722.00257.0075;ESCO.0722.00257.0075b_04631;12;1169;1157
ESCO.0722.00257;ESCO.0722.00257.0095;ESCO.0722.00257.0095b_04695;1284;1967;683
ESCO.0722.00257;ESCO.0722.00257.0011;ESCO.0722.00257.0011i_01490;280805;281926;1121
ESCO.0722.00257;ESCO.0722.00257.0046;ESCO.0722.00257.0046i_04146;8541;8720;179
ESCO.0722.00257;ESCO.0722.00257.0094;ESCO.0722.00257.0094b_04690;1;216;215
ESCO.0722.00257;ESCO.0722.00257.0174;ESCO.0722.00257.0174b_04786;2;286;284
ESCO.0722.00257;ESCO.0722.00257.0215;ESCO.0722.00257.0215b_04818;2;205;203
ESCO.0722.00257;ESCO.0722.00257.0270;ESCO.0722.00257.0270b_04850;1;75;74
ESCO.0722.00257;ESCO.0722.00257.0016;ESCO.0722.00257.0016i_02195;42135;42434;299
ESCO.0722.00257;ESCO.0722.00257.0046;ESCO.0722.00257.0046i_04147;8994;9644;650
ESCO.0722.00257;ESCO.0722.00257.0144;ESCO.0722.00257.0144b_04755;1;402;401
ESCO.0722.00257;ESCO.0722.00257.0217;ESCO.0722.00257.0217b_04819;2;193;191
ESCO.0722.00257;ESCO.0722.00257.0037;ESCO.0722.00257.0037b_03796;1;345;344
ESCO.0722.00257;ESCO.0722.00257.0046;ESCO.0722.00257.0046i_04148;9683;10138;455
ESCO.0722.00257;ESCO.0722.00257.0219;ESCO.0722.00257.0219b_04820;1;87;86
ESCO.0722.00257;ESCO.0722.00257.0273;ESCO.0722.00257.0273b_04852;2;73;71
ESCO.0722.00257;ESCO.0722.00257.0033;ESCO.0722.00257.0033i_03548;3342;4274;932
ESCO.0722.00257;ESCO.0722.00257.0035;ESCO.0722.00257.0035i_03676;571;864;293
ESCO.0722.00257;ESCO.0722.00257.0046;ESCO.0722.00257.0046i_04156;19029;20057;1028
ESCO.0722.00257;ESCO.0722.00257.0055;ESCO.0722.00257.0055i_04412;9841;10377;536
ESCO.0722.00257;ESCO.0722.00257.0046;ESCO.0722.00257.0046i_04135;2929;3213;284
ESCO.0722.00257;ESCO.0722.00257.0046;ESCO.0722.00257.0046i_04167;28968;29198;230
ESCO.0722.00257;ESCO.0722.00257.0046;ESCO.0722.00257.0046i_04136;3309;3971;662
ESCO.0722.00257;ESCO.0722.00257.0046;ESCO.0722.00257.0046i_04168;29152;29658;506
ESCO.0722.00257;ESCO.0722.00257.0049;ESCO.0722.00257.0049i_04264;25029;25838;809
ESCO.0722.00257;ESCO.0722.00257.0072;ESCO.0722.00257.0072b_04616;136;417;281
ESCO.0722.00257;ESCO.0722.00257.0201;ESCO.0722.00257.0201b_04808;92;226;134
ESCO.0722.00257;ESCO.0722.00257.0007;ESCO.0722.00257.0007b_00649;141;1592;1451
ESCO.0722.00257;ESCO.0722.00257.0046;ESCO.0722.00257.0046i_04137;4349;4993;644
ESCO.0722.00257;ESCO.0722.00257.0072;ESCO.0722.00257.0072i_04617;603;806;203
ESCO.0722.00257;ESCO.0722.00257.0079;ESCO.0722.00257.0079b_04649;3084;4127;1043
ESCO.0722.00257;ESCO.0722.00257.0202;ESCO.0722.00257.0202b_04809;3;221;218
ESCO.0722.00257;ESCO.0722.00257.0256;ESCO.0722.00257.0256b_04841;2;109;107
ESCO.0722.00257;ESCO.0722.00257.0046;ESCO.0722.00257.0046i_04132;1458;1898;440
ESCO.0722.00257;ESCO.0722.00257.0046;ESCO.0722.00257.0046i_04133;1984;2337;353
ESCO.0722.00257;ESCO.0722.00257.0088;ESCO.0722.00257.0088b_04677;1;906;905
ESCO.0722.00257;ESCO.0722.00257.0250;ESCO.0722.00257.0250b_04837;1;111;110
ESCO.0722.00257;ESCO.0722.00257.0046;ESCO.0722.00257.0046i_04134;2392;2925;533
ESCO.0722.00257;ESCO.0722.00257.0079;ESCO.0722.00257.0079b_04646;2;1171;1169
ESCO.0722.00257;ESCO.0722.00257.0199;ESCO.0722.00257.0199b_04806;2;88;86
ESCO.0722.00257;ESCO.0722.00257.0046;ESCO.0722.00257.0046i_04143;7065;7340;275
ESCO.0722.00257;ESCO.0722.00257.0066;ESCO.0722.00257.0066i_04591;7883;9406;1523
ESCO.0722.00257;ESCO.0722.00257.0212;ESCO.0722.00257.0212b_04815;112;207;95
ESCO.0722.00257;ESCO.0722.00257.0263;ESCO.0722.00257.0263b_04847;1;99;98
ESCO.0722.00257;ESCO.0722.00257.0021;ESCO.0722.00257.0021b_02928;107413;107637;224
ESCO.0722.00257;ESCO.0722.00257.0046;ESCO.0722.00257.0046i_04144;7358;7612;254
ESCO.0722.00257;ESCO.0722.00257.0213;ESCO.0722.00257.0213b_04816;114;206;92
ESCO.0722.00257;ESCO.0722.00257.0016;ESCO.0722.00257.0016i_02289;135731;136555;824
ESCO.0722.00257;ESCO.0722.00257.0046;ESCO.0722.00257.0046i_04145;7723;8544;821
ESCO.0722.00257;ESCO.0722.00257.0214;ESCO.0722.00257.0214b_04817;111;206;95
ESCO.0722.00257;ESCO.0722.00257.0267;ESCO.0722.00257.0267b_04849;2;82;80
ESCO.0722.00257;ESCO.0722.00257.0046;ESCO.0722.00257.0046i_04154;16802;17194;392
ESCO.0722.00257;ESCO.0722.00257.0084;ESCO.0722.00257.0084b_04666;3059;3148;89
ESCO.0722.00257;ESCO.0722.00257.0035;ESCO.0722.00257.0035i_03743;55980;56162;182
ESCO.0722.00257;ESCO.0722.00257.0046;ESCO.0722.00257.0046i_04159;22202;22924;722
ESCO.0722.00257;ESCO.0722.00257.0238;ESCO.0722.00257.0238b_04831;3;134;131
ESCO.0722.00257;ESCO.0722.00257.0046;ESCO.0722.00257.0046i_04160;22914;23042;128
ESCO.0722.00257;ESCO.0722.00257.0046;ESCO.0722.00257.0046i_04161;23119;24174;1055
ESCO.0722.00257;ESCO.0722.00257.0126;ESCO.0722.00257.0126b_04737;394;480;86
ESCO.0722.00257;ESCO.0722.00257.0007;ESCO.0722.00257.0007i_00650;1585;3627;2042
ESCO.0722.00257;ESCO.0722.00257.0046;ESCO.0722.00257.0046i_04138;5114;5353;239
ESCO.0722.00257;ESCO.0722.00257.0072;ESCO.0722.00257.0072i_04618;706;1518;812
ESCO.0722.00257;ESCO.0722.00257.0091;ESCO.0722.00257.0091b_04682;3;440;437
ESCO.0722.00257;ESCO.0722.00257.0007;ESCO.0722.00257.0007i_00651;3814;9549;5735
ESCO.0722.00257;ESCO.0722.00257.0023;ESCO.0722.00257.0023b_03019;146;748;602
ESCO.0722.00257;ESCO.0722.00257.0046;ESCO.0722.00257.0046i_04139;5356;5736;380
ESCO.0722.00257;ESCO.0722.00257.0046;ESCO.0722.00257.0046i_04171;32069;32317;248
ESCO.0722.00257;ESCO.0722.00257.0061;ESCO.0722.00257.0061b_04523;2;2674;2672
ESCO.0722.00257;ESCO.0722.00257.0136;ESCO.0722.00257.0136b_04747;297;413;116
ESCO.0722.00257;ESCO.0722.00257.0206;ESCO.0722.00257.0206b_04811;3;218;215
ESCO.0722.00257;ESCO.0722.00257.0046;ESCO.0722.00257.0046i_04172;32314;32478;164
ESCO.0722.00257;ESCO.0722.00257.0066;ESCO.0722.00257.0066i_04588;4192;6054;1862
ESCO.0722.00257;ESCO.0722.00257.0208;ESCO.0722.00257.0208b_04812;81;215;134
ESCO.0722.00257;ESCO.0722.00257.0150;ESCO.0722.00257.0150b_04763;2;382;380
ESCO.0722.00257;ESCO.0722.00257.0046;ESCO.0722.00257.0046i_04152;14361;16367;2006
ESCO.0722.00257;ESCO.0722.00257.0060;ESCO.0722.00257.0060i_04504;1947;2078;131
ESCO.0722.00257;ESCO.0722.00257.0096;ESCO.0722.00257.0096b_04696;1;1965;1964
ESCO.0722.00257;ESCO.0722.00257.0046;ESCO.0722.00257.0046i_04153;16445;16750;305
ESCO.0722.00258;ESCO.0722.00258.0001;ESCO.0722.00258.0001i_00039;29368;29526;158
ESCO.0722.00258;ESCO.0722.00258.0020;ESCO.0722.00258.0020i_02439;10391;11140;749
ESCO.0722.00258;ESCO.0722.00258.0020;ESCO.0722.00258.0020i_02471;29182;29946;764
ESCO.0722.00258;ESCO.0722.00258.0030;ESCO.0722.00258.0030i_03559;53588;53767;179
ESCO.0722.00258;ESCO.0722.00258.0063;ESCO.0722.00258.0063i_04679;881;1096;215
ESCO.0722.00258;ESCO.0722.00258.0122;ESCO.0722.00258.0122b_04903;3;206;203
ESCO.0722.00258;ESCO.0722.00258.0240;ESCO.0722.00258.0240b_05031;3;224;221
ESCO.0722.00258;ESCO.0722.00258.0001;ESCO.0722.00258.0001i_00023;19684;19866;182
ESCO.0722.00258;ESCO.0722.00258.0001;ESCO.0722.00258.0001i_00055;41896;42381;485
ESCO.0722.00258;ESCO.0722.00258.0028;ESCO.0722.00258.0028i_03319;27829;28182;353
ESCO.0722.00258;ESCO.0722.00258.0085;ESCO.0722.00258.0085i_04823;635;955;320
ESCO.0722.00258;ESCO.0722.00258.0260;ESCO.0722.00258.0260b_05047;3;215;212
ESCO.0722.00258;ESCO.0722.00258.0355;ESCO.0722.00258.0355b_05111;3;83;80
ESCO.0722.00258;ESCO.0722.00258.0001;ESCO.0722.00258.0001i_00056;42378;43547;1169
ESCO.0722.00258;ESCO.0722.00258.0020;ESCO.0722.00258.0020i_02456;18783;19262;479
ESCO.0722.00258;ESCO.0722.00258.0028;ESCO.0722.00258.0028i_03320;28179;28700;521
ESCO.0722.00258;ESCO.0722.00258.0079;ESCO.0722.00258.0079b_04792;3;1121;1118
ESCO.0722.00258;ESCO.0722.00258.0186;ESCO.0722.00258.0186b_04984;2;286;284
ESCO.0722.00258;ESCO.0722.00258.0303;ESCO.0722.00258.0303b_05080;2;133;131
ESCO.0722.00258;ESCO.0722.00258.0001;ESCO.0722.00258.0001i_00044;31785;32420;635
ESCO.0722.00258;ESCO.0722.00258.0020;ESCO.0722.00258.0020i_02444;12854;13303;449
ESCO.0722.00258;ESCO.0722.00258.0020;ESCO.0722.00258.0020i_02476;32377;32850;473
ESCO.0722.00258;ESCO.0722.00258.0030;ESCO.0722.00258.0030i_03564;55495;55797;302
ESCO.0722.00258;ESCO.0722.00258.0093;ESCO.0722.00258.0093b_04844;2;73;71
ESCO.0722.00258;ESCO.0722.00258.0001;ESCO.0722.00258.0001i_00013;13026;14075;1049
ESCO.0722.00258;ESCO.0722.00258.0001;ESCO.0722.00258.0001i_00045;32417;32764;347
ESCO.0722.00258;ESCO.0722.00258.0004;ESCO.0722.00258.0004i_00461;23807;24547;740
ESCO.0722.00258;ESCO.0722.00258.0020;ESCO.0722.00258.0020i_02477;32905;35622;2717
ESCO.0722.00258;ESCO.0722.00258.0151;ESCO.0722.00258.0151b_04941;3;422;419
ESCO.0722.00258;ESCO.0722.00258.0175;ESCO.0722.00258.0175b_04973;252;329;77
ESCO.0722.00258;ESCO.0722.00258.0208;ESCO.0722.00258.0208b_05005;2;253;251
ESCO.0722.00258;ESCO.0722.00258.0249;ESCO.0722.00258.0249b_05037;2;220;218
ESCO.0722.00258;ESCO.0722.00258.0334;ESCO.0722.00258.0334b_05101;3;107;104
ESCO.0722.00258;ESCO.0722.00258.0001;ESCO.0722.00258.0001i_00031;24630;25484;854
ESCO.0722.00258;ESCO.0722.00258.0004;ESCO.0722.00258.0004i_00447;7619;8299;680
ESCO.0722.00258;ESCO.0722.00258.0020;ESCO.0722.00258.0020i_02431;5658;6317;659
ESCO.0722.00258;ESCO.0722.00258.0020;ESCO.0722.00258.0020i_02463;25781;26875;1094
ESCO.0722.00258;ESCO.0722.00258.0030;ESCO.0722.00258.0030i_03583;84483;85031;548
ESCO.0722.00258;ESCO.0722.00258.0043;ESCO.0722.00258.0043i_04255;1388;1762;374
ESCO.0722.00258;ESCO.0722.00258.0192;ESCO.0722.00258.0192b_04991;3;272;269
ESCO.0722.00258;ESCO.0722.00258.0229;ESCO.0722.00258.0229b_05023;33;230;197
ESCO.0722.00258;ESCO.0722.00258.0270;ESCO.0722.00258.0270b_05055;2;208;206
ESCO.0722.00258;ESCO.0722.00258.0311;ESCO.0722.00258.0311b_05087;3;125;122
ESCO.0722.00258;ESCO.0722.00258.0001;ESCO.0722.00258.0001i_00032;25561;26628;1067
ESCO.0722.00258;ESCO.0722.00258.0004;ESCO.0722.00258.0004i_00448;8300;8497;197
ESCO.0722.00258;ESCO.0722.00258.0020;ESCO.0722.00258.0020i_02432;6426;6644;218
ESCO.0722.00258;ESCO.0722.00258.0020;ESCO.0722.00258.0020i_02464;26886;27164;278
ESCO.0722.00258;ESCO.0722.00258.0230;ESCO.0722.00258.0230b_05024;79;228;149
ESCO.0722.00258;ESCO.0722.00258.0271;ESCO.0722.00258.0271b_05056;32;208;176
ESCO.0722.00258;ESCO.0722.00258.0312;ESCO.0722.00258.0312b_05088;1;123;122
ESCO.0722.00258;ESCO.0722.00258.0374;ESCO.0722.00258.0374b_05120;2;67;65
ESCO.0722.00258;ESCO.0722.00258.0001;ESCO.0722.00258.0001i_00033;26632;27381;749
ESCO.0722.00258;ESCO.0722.00258.0020;ESCO.0722.00258.0020i_02433;6675;7217;542
ESCO.0722.00258;ESCO.0722.00258.0020;ESCO.0722.00258.0020i_02465;27167;27550;383
ESCO.0722.00258;ESCO.0722.00258.0166;ESCO.0722.00258.0166b_04961;221;358;137
ESCO.0722.00258;ESCO.0722.00258.0272;ESCO.0722.00258.0272b_05057;3;209;206
ESCO.0722.00258;ESCO.0722.00258.0001;ESCO.0722.00258.0001i_00028;21386;21610;224
ESCO.0722.00258;ESCO.0722.00258.0020;ESCO.0722.00258.0020i_02428;3600;3773;173
ESCO.0722.00258;ESCO.0722.00258.0020;ESCO.0722.00258.0020i_02460;23164;23895;731
ESCO.0722.00258;ESCO.0722.00258.0028;ESCO.0722.00258.0028i_03324;29691;30209;518
ESCO.0722.00258;ESCO.0722.00258.0137;ESCO.0722.00258.0137b_04924;3;515;512
ESCO.0722.00258;ESCO.0722.00258.0163;ESCO.0722.00258.0163b_04956;3;197;194
ESCO.0722.00258;ESCO.0722.00258.0226;ESCO.0722.00258.0226b_05020;1;144;143
ESCO.0722.00258;ESCO.0722.00258.0266;ESCO.0722.00258.0266b_05052;13;108;95
ESCO.0722.00258;ESCO.0722.00258.0001;ESCO.0722.00258.0001i_00029;21649;22695;1046
ESCO.0722.00258;ESCO.0722.00258.0020;ESCO.0722.00258.0020i_02429;4211;4408;197
ESCO.0722.00258;ESCO.0722.00258.0020;ESCO.0722.00258.0020i_02461;23955;25337;1382
ESCO.0722.00258;ESCO.0722.00258.0072;ESCO.0722.00258.0072b_04765;3;1556;1553
ESCO.0722.00258;ESCO.0722.00258.0163;ESCO.0722.00258.0163b_04957;210;374;164
ESCO.0722.00258;ESCO.0722.00258.0226;ESCO.0722.00258.0226b_05021;148;234;86
ESCO.0722.00258;ESCO.0722.00258.0267;ESCO.0722.00258.0267b_05053;3;209;206
ESCO.0722.00258;ESCO.0722.00258.0020;ESCO.0722.00258.0020i_02430;4543;5577;1034
ESCO.0722.00258;ESCO.0722.00258.0020;ESCO.0722.00258.0020i_02462;25341;25769;428
ESCO.0722.00258;ESCO.0722.00258.0268;ESCO.0722.00258.0268b_05054;1;210;209
ESCO.0722.00258;ESCO.0722.00258.0310;ESCO.0722.00258.0310b_05086;3;125;122
ESCO.0722.00258;ESCO.0722.00258.0001;ESCO.0722.00258.0001i_00038;28968;29381;413
ESCO.0722.00258;ESCO.0722.00258.0020;ESCO.0722.00258.0020i_02438;9888;10394;506
ESCO.0722.00258;ESCO.0722.00258.0020;ESCO.0722.00258.0020i_02470;28742;29122;380
ESCO.0722.00258;ESCO.0722.00258.0046;ESCO.0722.00258.0046b_04326;149;358;209
ESCO.0722.00258;ESCO.0722.00258.0057;ESCO.0722.00258.0057i_04614;1458;2756;1298
ESCO.0722.00258;ESCO.0722.00258.0063;ESCO.0722.00258.0063i_04678;297;842;545
ESCO.0722.00258;ESCO.0722.00258.0201;ESCO.0722.00258.0201b_04998;1;264;263
ESCO.0722.00258;ESCO.0722.00258.0239;ESCO.0722.00258.0239b_05030;51;224;173
ESCO.0722.00258;ESCO.0722.00258.0001;ESCO.0722.00258.0001i_00017;15811;16320;509
ESCO.0722.00258;ESCO.0722.00258.0020;ESCO.0722.00258.0020i_02449;15280;15678;398
ESCO.0722.00258;ESCO.0722.00258.0020;ESCO.0722.00258.0020i_02481;36974;40057;3083
ESCO.0722.00258;ESCO.0722.00258.0030;ESCO.0722.00258.0030i_03569;63154;65022;1868
ESCO.0722.00258;ESCO.0722.00258.0070;ESCO.0722.00258.0070b_04753;2;142;140
ESCO.0722.00258;ESCO.0722.00258.0254;ESCO.0722.00258.0254b_05041;97;219;122
ESCO.0722.00258;ESCO.0722.00258.0001;ESCO.0722.00258.0001i_00018;16328;16528;200
ESCO.0722.00258;ESCO.0722.00258.0020;ESCO.0722.00258.0020i_02450;15675;15956;281
ESCO.0722.00258;ESCO.0722.00258.0020;ESCO.0722.00258.0020i_02482;40115;42463;2348
ESCO.0722.00258;ESCO.0722.00258.0028;ESCO.0722.00258.0028i_03314;24663;25034;371
ESCO.0722.00258;ESCO.0722.00258.0030;ESCO.0722.00258.0030i_03570;65296;65865;569
ESCO.0722.00258;ESCO.0722.00258.0064;ESCO.0722.00258.0064i_04690;2264;2797;533
ESCO.0722.00258;ESCO.0722.00258.0070;ESCO.0722.00258.0070i_04754;197;1021;824
ESCO.0722.00258;ESCO.0722.00258.0180;ESCO.0722.00258.0180b_04978;2;298;296
ESCO.0722.00258;ESCO.0722.00258.0255;ESCO.0722.00258.0255b_05042;60;218;158
ESCO.0722.00258;ESCO.0722.00258.0294;ESCO.0722.00258.0294b_05074;1;153;152
ESCO.0722.00258;ESCO.0722.00258.0345;ESCO.0722.00258.0345b_05106;2;94;92
ESCO.0722.00258;ESCO.0722.00258.0001;ESCO.0722.00258.0001i_00019;16492;16830;338
ESCO.0722.00258;ESCO.0722.00258.0020;ESCO.0722.00258.0020i_02451;15953;16495;542
ESCO.0722.00258;ESCO.0722.00258.0020;ESCO.0722.00258.0020i_02483;42589;42828;239
ESCO.0722.00258;ESCO.0722.00258.0064;ESCO.0722.00258.0064i_04691;3382;6798;3416
ESCO.0722.00258;ESCO.0722.00258.0070;ESCO.0722.00258.0070i_04755;1262;3943;2681
ESCO.0722.00258;ESCO.0722.00258.0256;ESCO.0722.00258.0256b_05043;1;216;215
ESCO.0722.00258;ESCO.0722.00258.0296;ESCO.0722.00258.0296b_05075;2;112;110
ESCO.0722.00258;ESCO.0722.00258.0001;ESCO.0722.00258.0001i_00014;14100;14438;338
ESCO.0722.00258;ESCO.0722.00258.0020;ESCO.0722.00258.0020i_02446;13459;13743;284
ESCO.0722.00258;ESCO.0722.00258.0020;ESCO.0722.00258.0020i_02478;35632;36102;470
ESCO.0722.00258;ESCO.0722.00258.0063;ESCO.0722.00258.0063i_04686;11379;12608;1229
ESCO.0722.00258;ESCO.0722.00258.0152;ESCO.0722.00258.0152b_04942;2;418;416
ESCO.0722.00258;ESCO.0722.00258.0251;ESCO.0722.00258.0251b_05038;1;219;218
ESCO.0722.00258;ESCO.0722.00258.0001;ESCO.0722.00258.0001i_00015;14448;15293;845
ESCO.0722.00258;ESCO.0722.00258.0001;ESCO.0722.00258.0001i_00047;33672;34280;608
ESCO.0722.00258;ESCO.0722.00258.0020;ESCO.0722.00258.0020i_02447;13740;14099;359
ESCO.0722.00258;ESCO.0722.00258.0020;ESCO.0722.00258.0020i_02479;36099;36587;488
ESCO.0722.00258;ESCO.0722.00258.0030;ESCO.0722.00258.0030b_03503;1;90;89
ESCO.0722.00258;ESCO.0722.00258.0153;ESCO.0722.00258.0153b_04943;3;137;134
ESCO.0722.00258;ESCO.0722.00258.0177;ESCO.0722.00258.0177b_04975;60;317;257
ESCO.0722.00258;ESCO.0722.00258.0211;ESCO.0722.00258.0211b_05007;2;67;65
ESCO.0722.00258;ESCO.0722.00258.0339;ESCO.0722.00258.0339b_05103;2;100;98
ESCO.0722.00258;ESCO.0722.00258.0001;ESCO.0722.00258.0001i_00016;15407;15778;371
ESCO.0722.00258;ESCO.0722.00258.0001;ESCO.0722.00258.0001i_00048;34277;35395;1118
ESCO.0722.00258;ESCO.0722.00258.0020;ESCO.0722.00258.0020i_02448;14215;14994;779
ESCO.0722.00258;ESCO.0722.00258.0020;ESCO.0722.00258.0020i_02480;36597;36977;380
ESCO.0722.00258;ESCO.0722.00258.0030;ESCO.0722.00258.0030i_03568;60861;63095;2234
ESCO.0722.00258;ESCO.0722.00258.0064;ESCO.0722.00258.0064b_04688;36;275;239
ESCO.0722.00258;ESCO.0722.00258.0253;ESCO.0722.00258.0253b_05040;107;217;110
ESCO.0722.00258;ESCO.0722.00258.0001;ESCO.0722.00258.0001i_00025;20299;20508;209
ESCO.0722.00258;ESCO.0722.00258.0020;ESCO.0722.00258.0020i_02457;19249;20721;1472
ESCO.0722.00258;ESCO.0722.00258.0030;ESCO.0722.00258.0030i_03545;35847;36194;347
ESCO.0722.00258;ESCO.0722.00258.0060;ESCO.0722.00258.0060b_04633;951;1772;821
ESCO.0722.00258;ESCO.0722.00258.0079;ESCO.0722.00258.0079i_04793;1243;1338;95
ESCO.0722.00258;ESCO.0722.00258.0263;ESCO.0722.00258.0263b_05049;139;213;74
ESCO.0722.00258;ESCO.0722.00258.0304;ESCO.0722.00258.0304b_05081;23;133;110
ESCO.0722.00258;ESCO.0722.00258.0001;ESCO.0722.00258.0001i_00026;20642;20836;194
ESCO.0722.00258;ESCO.0722.00258.0020;ESCO.0722.00258.0020i_02426;2821;3060;239
ESCO.0722.00258;ESCO.0722.00258.0020;ESCO.0722.00258.0020i_02458;20733;22181;1448
ESCO.0722.00258;ESCO.0722.00258.0079;ESCO.0722.00258.0079i_04794;1352;3559;2207
ESCO.0722.00258;ESCO.0722.00258.0135;ESCO.0722.00258.0135b_04922;1;534;533
ESCO.0722.00258;ESCO.0722.00258.0224;ESCO.0722.00258.0224b_05018;3;236;233
ESCO.0722.00258;ESCO.0722.00258.0264;ESCO.0722.00258.0264b_05050;1;165;164
ESCO.0722.00258;ESCO.0722.00258.0020;ESCO.0722.00258.0020i_02427;3332;3610;278
ESCO.0722.00258;ESCO.0722.00258.0020;ESCO.0722.00258.0020i_02459;22189;23121;932
ESCO.0722.00258;ESCO.0722.00258.0030;ESCO.0722.00258.0030i_03579;78715;81846;3131
ESCO.0722.00258;ESCO.0722.00258.0098;ESCO.0722.00258.0098b_04859;893;1645;752
ESCO.0722.00258;ESCO.0722.00258.0136;ESCO.0722.00258.0136b_04923;1;528;527
ESCO.0722.00258;ESCO.0722.00258.0189;ESCO.0722.00258.0189b_04987;2;277;275
ESCO.0722.00258;ESCO.0722.00258.0225;ESCO.0722.00258.0225b_05019;96;236;140
ESCO.0722.00258;ESCO.0722.00258.0265;ESCO.0722.00258.0265b_05051;1;210;209
ESCO.0722.00258;ESCO.0722.00258.0364;ESCO.0722.00258.0364b_05115;2;76;74
ESCO.0722.00258;ESCO.0722.00258.0020;ESCO.0722.00258.0020i_02468;27946;28302;356
ESCO.0722.00258;ESCO.0722.00258.0120;ESCO.0722.00258.0120b_04900;3;377;374
ESCO.0722.00258;ESCO.0722.00258.0144;ESCO.0722.00258.0144b_04932;3;446;443
ESCO.0722.00258;ESCO.0722.00258.0200;ESCO.0722.00258.0200b_04996;1;198;197
ESCO.0722.00258;ESCO.0722.00258.0276;ESCO.0722.00258.0276b_05060;3;206;203
ESCO.0722.00258;ESCO.0722.00258.0317;ESCO.0722.00258.0317b_05092;1;117;116
ESCO.0722.00258;ESCO.0722.00258.0001;ESCO.0722.00258.0001i_00040;29489;29956;467
ESCO.0722.00258;ESCO.0722.00258.0020;ESCO.0722.00258.0020i_02472;30003;30674;671
ESCO.0722.00258;ESCO.0722.00258.0030;ESCO.0722.00258.0030i_03560;53778;54218;440
ESCO.0722.00258;ESCO.0722.00258.0090;ESCO.0722.00258.0090b_04840;1497;2279;782
ESCO.0722.00258;ESCO.0722.00258.0122;ESCO.0722.00258.0122b_04904;306;881;575
ESCO.0722.00258;ESCO.0722.00258.0147;ESCO.0722.00258.0147b_04936;277;432;155
ESCO.0722.00258;ESCO.0722.00258.0241;ESCO.0722.00258.0241b_05032;142;222;80
ESCO.0722.00258;ESCO.0722.00258.0322;ESCO.0722.00258.0322b_05096;2;109;107
ESCO.0722.00258;ESCO.0722.00258.0001;ESCO.0722.00258.0001i_00041;29949;30395;446
ESCO.0722.00258;ESCO.0722.00258.0020;ESCO.0722.00258.0020i_02441;11348;12046;698
ESCO.0722.00258;ESCO.0722.00258.0020;ESCO.0722.00258.0020i_02473;30870;31400;530
ESCO.0722.00258;ESCO.0722.00258.0030;ESCO.0722.00258.0030i_03529;17738;18103;365
ESCO.0722.00258;ESCO.0722.00258.0030;ESCO.0722.00258.0030i_03561;54218;54655;437
ESCO.0722.00258;ESCO.0722.00258.0050;ESCO.0722.00258.0050i_04457;8444;8719;275
ESCO.0722.00258;ESCO.0722.00258.0058;ESCO.0722.00258.0058b_04617;3;644;641
ESCO.0722.00258;ESCO.0722.00258.0074;ESCO.0722.00258.0074i_04777;2507;2908;401
ESCO.0722.00258;ESCO.0722.00258.0242;ESCO.0722.00258.0242b_05033;1;183;182
ESCO.0722.00258;ESCO.0722.00258.0001;ESCO.0722.00258.0001i_00042;30450;31094;644
ESCO.0722.00258;ESCO.0722.00258.0020;ESCO.0722.00258.0020i_02442;12048;12485;437
ESCO.0722.00258;ESCO.0722.00258.0020;ESCO.0722.00258.0020i_02474;31437;31658;221
ESCO.0722.00258;ESCO.0722.00258.0030;ESCO.0722.00258.0030i_03530;18064;18399;335
ESCO.0722.00258;ESCO.0722.00258.0030;ESCO.0722.00258.0030i_03562;54652;54756;104
ESCO.0722.00258;ESCO.0722.00258.0245;ESCO.0722.00258.0245b_05034;1;222;221
ESCO.0722.00258;ESCO.0722.00258.0001;ESCO.0722.00258.0001i_00043;31087;31608;521
ESCO.0722.00258;ESCO.0722.00258.0020;ESCO.0722.00258.0020i_02443;12546;12827;281
ESCO.0722.00258;ESCO.0722.00258.0020;ESCO.0722.00258.0020i_02475;31688;32266;578
ESCO.0722.00258;ESCO.0722.00258.0030;ESCO.0722.00258.0030i_03563;54823;54951;128
ESCO.0722.00258;ESCO.0722.00258.0105;ESCO.0722.00258.0105b_04875;1;1341;1340
ESCO.0722.00258;ESCO.0722.00258.0174;ESCO.0722.00258.0174b_04971;1;336;335
ESCO.0722.00258;ESCO.0722.00258.0246;ESCO.0722.00258.0246b_05035;1;222;221
ESCO.0722.00258;ESCO.0722.00258.0285;ESCO.0722.00258.0285b_05067;3;170;167
ESCO.0722.00258;ESCO.0722.00258.0001;ESCO.0722.00258.0001i_00020;16898;17125;227
ESCO.0722.00258;ESCO.0722.00258.0001;ESCO.0722.00258.0001i_00052;38376;38894;518
ESCO.0722.00258;ESCO.0722.00258.0020;ESCO.0722.00258.0020i_02452;16492;16764;272
ESCO.0722.00258;ESCO.0722.00258.0020;ESCO.0722.00258.0020i_02484;42828;43145;317
ESCO.0722.00258;ESCO.0722.00258.0050;ESCO.0722.00258.0050i_04468;19477;20496;1019
ESCO.0722.00258;ESCO.0722.00258.0257;ESCO.0722.00258.0257b_05044;3;152;149
ESCO.0722.00258;ESCO.0722.00258.0347;ESCO.0722.00258.0347b_05108;2;91;89
ESCO.0722.00258;ESCO.0722.00258.0001;ESCO.0722.00258.0001i_00021;17125;17346;221
ESCO.0722.00258;ESCO.0722.00258.0001;ESCO.0722.00258.0001i_00053;38958;39293;335
ESCO.0722.00258;ESCO.0722.00258.0020;ESCO.0722.00258.0020i_02421;205;1122;917
ESCO.0722.00258;ESCO.0722.00258.0020;ESCO.0722.00258.0020i_02453;16961;17140;179
ESCO.0722.00258;ESCO.0722.00258.0028;ESCO.0722.00258.0028i_03317;27268;27405;137
ESCO.0722.00258;ESCO.0722.00258.0030;ESCO.0722.00258.0030i_03573;70265;70537;272
ESCO.0722.00258;ESCO.0722.00258.0046;ESCO.0722.00258.0046i_04341;15562;15741;179
ESCO.0722.00258;ESCO.0722.00258.0064;ESCO.0722.00258.0064i_04693;8940;9131;191
ESCO.0722.00258;ESCO.0722.00258.0157;ESCO.0722.00258.0157b_04949;1;405;404
ESCO.0722.00258;ESCO.0722.00258.0217;ESCO.0722.00258.0217b_05013;3;248;245
ESCO.0722.00258;ESCO.0722.00258.0258;ESCO.0722.00258.0258b_05045;3;215;212
ESCO.0722.00258;ESCO.0722.00258.0001;ESCO.0722.00258.0001i_00022;17348;19570;2222
ESCO.0722.00258;ESCO.0722.00258.0001;ESCO.0722.00258.0001i_00054;39438;41882;2444
ESCO.0722.00258;ESCO.0722.00258.0020;ESCO.0722.00258.0020i_02422;1132;1410;278
ESCO.0722.00258;ESCO.0722.00258.0020;ESCO.0722.00258.0020i_02454;17253;17987;734
ESCO.0722.00258;ESCO.0722.00258.0030;ESCO.0722.00258.0030i_03574;71131;71226;95
ESCO.0722.00258;ESCO.0722.00258.0085;ESCO.0722.00258.0085i_04822;297;638;341
ESCO.0722.00258;ESCO.0722.00258.0132;ESCO.0722.00258.0132b_04918;259;585;326
ESCO.0722.00258;ESCO.0722.00258.0184;ESCO.0722.00258.0184b_04982;2;289;287
ESCO.0722.00258;ESCO.0722.00258.0219;ESCO.0722.00258.0219b_05014;1;243;242
ESCO.0722.00258;ESCO.0722.00258.0259;ESCO.0722.00258.0259b_05046;2;214;212
ESCO.0722.00258;ESCO.0722.00258.0020;ESCO.0722.00258.0020i_02437;9547;9891;344
ESCO.0722.00258;ESCO.0722.00258.0020;ESCO.0722.00258.0020i_02469;28305;28745;440
ESCO.0722.00258;ESCO.0722.00258.0102;ESCO.0722.00258.0102b_04869;646;1419;773
ESCO.0722.00258;ESCO.0722.00258.0145;ESCO.0722.00258.0145b_04933;21;440;419
ESCO.0722.00258;ESCO.0722.00258.0169;ESCO.0722.00258.0169b_04965;30;347;317
ESCO.0722.00258;ESCO.0722.00258.0200;ESCO.0722.00258.0200b_04997;198;263;65
ESCO.0722.00258;ESCO.0722.00258.0277;ESCO.0722.00258.0277b_05061;2;202;200
ESCO.0722.00258;ESCO.0722.00258.0001;ESCO.0722.00258.0001i_00034;27475;27984;509
ESCO.0722.00258;ESCO.0722.00258.0020;ESCO.0722.00258.0020i_02434;7303;7995;692
ESCO.0722.00258;ESCO.0722.00258.0020;ESCO.0722.00258.0020i_02466;27550;27723;173
ESCO.0722.00258;ESCO.0722.00258.0040;ESCO.0722.00258.0040i_04130;3618;4181;563
ESCO.0722.00258;ESCO.0722.00258.0102;ESCO.0722.00258.0102b_04866;2;160;158
ESCO.0722.00258;ESCO.0722.00258.0273;ESCO.0722.00258.0273b_05058;2;208;206
ESCO.0722.00258;ESCO.0722.00258.0001;ESCO.0722.00258.0001i_00035;27984;28187;203
ESCO.0722.00258;ESCO.0722.00258.0020;ESCO.0722.00258.0020i_02435;7996;8859;863
ESCO.0722.00258;ESCO.0722.00258.0168;ESCO.0722.00258.0168b_04963;1;147;146
ESCO.0722.00258;ESCO.0722.00258.0233;ESCO.0722.00258.0233b_05027;3;224;221
ESCO.0722.00258;ESCO.0722.00258.0274;ESCO.0722.00258.0274b_05059;3;206;203
ESCO.0722.00269;ESCO.0722.00269.0012;ESCO.0722.00269.0012i_01860;201840;202019;179
ESCO.0722.00269;ESCO.0722.00269.0028;ESCO.0722.00269.0028b_03204;51;1526;1475
ESCO.0722.00269;ESCO.0722.00269.0050;ESCO.0722.00269.0050i_04324;16638;16979;341
ESCO.0722.00269;ESCO.0722.00269.0070;ESCO.0722.00269.0070i_04644;4349;4552;203
ESCO.0722.00269;ESCO.0722.00269.0074;ESCO.0722.00269.0074i_04676;5145;5390;245
ESCO.0722.00269;ESCO.0722.00269.0180;ESCO.0722.00269.0180b_04868;3;155;152
ESCO.0722.00269;ESCO.0722.00269.0028;ESCO.0722.00269.0028i_03251;68635;71493;2858
ESCO.0722.00269;ESCO.0722.00269.0050;ESCO.0722.00269.0050i_04307;2538;2765;227
ESCO.0722.00269;ESCO.0722.00269.0069;ESCO.0722.00269.0069i_04627;549;1445;896
ESCO.0722.00269;ESCO.0722.00269.0095;ESCO.0722.00269.0095b_04755;2;223;221
ESCO.0722.00269;ESCO.0722.00269.0028;ESCO.0722.00269.0028i_03252;71717;78031;6314
ESCO.0722.00269;ESCO.0722.00269.0032;ESCO.0722.00269.0032i_03540;4177;4455;278
ESCO.0722.00269;ESCO.0722.00269.0059;ESCO.0722.00269.0059b_04532;14668;15174;506
ESCO.0722.00269;ESCO.0722.00269.0001;ESCO.0722.00269.0001i_00565;593472;594185;713
ESCO.0722.00269;ESCO.0722.00269.0028;ESCO.0722.00269.0028i_03253;78031;81390;3359
ESCO.0722.00269;ESCO.0722.00269.0057;ESCO.0722.00269.0057b_04501;15872;16000;128
ESCO.0722.00269;ESCO.0722.00269.0223;ESCO.0722.00269.0223b_04885;1;108;107
ESCO.0722.00269;ESCO.0722.00269.0189;ESCO.0722.00269.0189b_04873;136;207;71
ESCO.0722.00269;ESCO.0722.00269.0070;ESCO.0722.00269.0070b_04650;6600;7223;623
ESCO.0722.00269;ESCO.0722.00269.0190;ESCO.0722.00269.0190b_04874;3;164;161
ESCO.0722.00269;ESCO.0722.00269.0070;ESCO.0722.00269.0070i_04642;1941;2936;995
ESCO.0722.00269;ESCO.0722.00269.0074;ESCO.0722.00269.0074i_04674;4019;4561;542
ESCO.0722.00269;ESCO.0722.00269.0003;ESCO.0722.00269.0003i_00796;209292;209516;224
ESCO.0722.00269;ESCO.0722.00269.0050;ESCO.0722.00269.0050i_04316;10533;11738;1205
ESCO.0722.00269;ESCO.0722.00269.0069;ESCO.0722.00269.0069i_04636;6644;6955;311
ESCO.0722.00269;ESCO.0722.00269.0088;ESCO.0722.00269.0088b_04732;2;544;542
ESCO.0722.00269;ESCO.0722.00269.0171;ESCO.0722.00269.0171b_04860;2;235;233
ESCO.0722.00269;ESCO.0722.00269.0003;ESCO.0722.00269.0003i_00797;209467;209919;452
ESCO.0722.00269;ESCO.0722.00269.0021;ESCO.0722.00269.0021i_02653;17083;17568;485
ESCO.0722.00269;ESCO.0722.00269.0028;ESCO.0722.00269.0028i_03261;88184;88648;464
ESCO.0722.00269;ESCO.0722.00269.0050;ESCO.0722.00269.0050i_04317;11740;12771;1031
ESCO.0722.00269;ESCO.0722.00269.0069;ESCO.0722.00269.0069i_04637;7024;7173;149
ESCO.0722.00269;ESCO.0722.00269.0081;ESCO.0722.00269.0081i_04701;3737;3988;251
ESCO.0722.00269;ESCO.0722.00269.0019;ESCO.0722.00269.0019i_02366;3912;4208;296
ESCO.0722.00269;ESCO.0722.00269.0021;ESCO.0722.00269.0021i_02654;17547;18191;644
ESCO.0722.00269;ESCO.0722.00269.0028;ESCO.0722.00269.0028i_03262;88877;90244;1367
ESCO.0722.00269;ESCO.0722.00269.0029;ESCO.0722.00269.0029i_03294;30327;30542;215
ESCO.0722.00269;ESCO.0722.00269.0069;ESCO.0722.00269.0069b_04638;7186;7458;272
ESCO.0722.00269;ESCO.0722.00269.0074;ESCO.0722.00269.0074b_04670;1;402;401
ESCO.0722.00269;ESCO.0722.00269.0174;ESCO.0722.00269.0174b_04862;141;230;89
ESCO.0722.00269;ESCO.0722.00269.0028;ESCO.0722.00269.0028i_03257;85285;85512;227
ESCO.0722.00269;ESCO.0722.00269.0050;ESCO.0722.00269.0050i_04313;7511;8644;1133
ESCO.0722.00269;ESCO.0722.00269.0028;ESCO.0722.00269.0028i_03258;85550;85894;344
ESCO.0722.00269;ESCO.0722.00269.0050;ESCO.0722.00269.0050i_04314;8889;9602;713
ESCO.0722.00269;ESCO.0722.00269.0110;ESCO.0722.00269.0110b_04794;387;1109;722
ESCO.0722.00269;ESCO.0722.00269.0069;ESCO.0722.00269.0069i_04635;6273;6647;374
ESCO.0722.00269;ESCO.0722.00269.0111;ESCO.0722.00269.0111b_04795;1;1011;1010
ESCO.0722.00269;ESCO.0722.00269.0170;ESCO.0722.00269.0170b_04859;84;236;152
ESCO.0722.00269;ESCO.0722.00269.0012;ESCO.0722.00269.0012i_01859;201606;201782;176
ESCO.0722.00269;ESCO.0722.00269.0070;ESCO.0722.00269.0070i_04643;3098;4336;1238
ESCO.0722.00269;ESCO.0722.00269.0001;ESCO.0722.00269.0001i_00558;586365;588140;1775
ESCO.0722.00269;ESCO.0722.00269.0010;ESCO.0722.00269.0010i_01422;30463;31353;890
ESCO.0722.00269;ESCO.0722.00269.0028;ESCO.0722.00269.0028i_03246;53240;53479;239
ESCO.0722.00269;ESCO.0722.00269.0057;ESCO.0722.00269.0057i_04494;10396;11508;1112
ESCO.0722.00269;ESCO.0722.00269.0093;ESCO.0722.00269.0093i_04750;1973;2272;299
ESCO.0722.00269;ESCO.0722.00269.0102;ESCO.0722.00269.0102b_04782;1120;1599;479
ESCO.0722.00269;ESCO.0722.00269.0153;ESCO.0722.00269.0153b_04846;2;94;92
ESCO.0722.00269;ESCO.0722.00269.0010;ESCO.0722.00269.0010i_01423;31380;32318;938
ESCO.0722.00269;ESCO.0722.00269.0028;ESCO.0722.00269.0028i_03247;54091;54741;650
ESCO.0722.00269;ESCO.0722.00269.0050;ESCO.0722.00269.0050b_04335;26015;26368;353
ESCO.0722.00269;ESCO.0722.00269.0093;ESCO.0722.00269.0093b_04751;2485;2697;212
ESCO.0722.00269;ESCO.0722.00269.0153;ESCO.0722.00269.0153b_04847;201;278;77
ESCO.0722.00269;ESCO.0722.00269.0028;ESCO.0722.00269.0028i_03248;55255;57369;2114
ESCO.0722.00269;ESCO.0722.00269.0062;ESCO.0722.00269.0062b_04560;1;135;134
ESCO.0722.00269;ESCO.0722.00269.0029;ESCO.0722.00269.0029i_03307;37656;38081;425
ESCO.0722.00269;ESCO.0722.00269.0029;ESCO.0722.00269.0029i_03308;38078;39064;986
ESCO.0722.00269;ESCO.0722.00269.0029;ESCO.0722.00269.0029i_03340;62580;64340;1760
ESCO.0722.00269;ESCO.0722.00269.0042;ESCO.0722.00269.0042i_04012;38978;39268;290
ESCO.0722.00269;ESCO.0722.00269.0093;ESCO.0722.00269.0093b_04748;187;378;191
ESCO.0722.00269;ESCO.0722.00269.0010;ESCO.0722.00269.0010i_01421;29098;30453;1355
ESCO.0722.00269;ESCO.0722.00269.0050;ESCO.0722.00269.0050i_04333;24985;25266;281
ESCO.0722.00269;ESCO.0722.00269.0093;ESCO.0722.00269.0093i_04749;1168;1893;725
ESCO.0722.00269;ESCO.0722.00269.0195;ESCO.0722.00269.0195b_04877;1;171;170
ESCO.0722.00269;ESCO.0722.00269.0028;ESCO.0722.00269.0028i_03254;81602;83254;1652
ESCO.0722.00269;ESCO.0722.00269.0058;ESCO.0722.00269.0058b_04502;5;211;206
ESCO.0722.00269;ESCO.0722.00269.0107;ESCO.0722.00269.0107b_04790;3;1265;1262
ESCO.0722.00269;ESCO.0722.00269.0003;ESCO.0722.00269.0003i_00695;97979;98467;488
ESCO.0722.00269;ESCO.0722.00269.0010;ESCO.0722.00269.0010b_01431;39653;40282;629
ESCO.0722.00269;ESCO.0722.00269.0028;ESCO.0722.00269.0028i_03255;83261;83968;707
ESCO.0722.00269;ESCO.0722.00269.0050;ESCO.0722.00269.0050i_04311;6515;7273;758
ESCO.0722.00269;ESCO.0722.00269.0028;ESCO.0722.00269.0028i_03256;83972;85075;1103
ESCO.0722.00269;ESCO.0722.00269.0050;ESCO.0722.00269.0050i_04312;7274;7501;227
ESCO.0722.00269;ESCO.0722.00269.0166;ESCO.0722.00269.0166b_04856;3;212;209
ESCO.0722.00269;ESCO.0722.00269.0012;ESCO.0722.00269.0012i_01857;201091;201279;188
ESCO.0722.00269;ESCO.0722.00269.0021;ESCO.0722.00269.0021i_02657;19353;19814;461
ESCO.0722.00269;ESCO.0722.00269.0177;ESCO.0722.00269.0177b_04865;128;229;101
ESCO.0722.00269;ESCO.0722.00269.0061;ESCO.0722.00269.0061b_04549;2;328;326
ESCO.0722.00269;ESCO.0722.00269.0074;ESCO.0722.00269.0074b_04677;5390;5965;575
ESCO.0722.00269;ESCO.0722.00269.0028;ESCO.0722.00269.0028i_03206;4156;5559;1403
ESCO.0722.00269;ESCO.0722.00269.0070;ESCO.0722.00269.0070i_04646;5523;5702;179
ESCO.0722.00269;ESCO.0722.00269.0145;ESCO.0722.00269.0145b_04838;248;340;92
ESCO.0722.00269;ESCO.0722.00269.0021;ESCO.0722.00269.0021b_02631;136;750;614
ESCO.0722.00269;ESCO.0722.00269.0186;ESCO.0722.00269.0186b_04871;2;187;185
ESCO.0722.00269;ESCO.0722.00269.0012;ESCO.0722.00269.0012b_01864;203038;203898;860
ESCO.0722.00269;ESCO.0722.00269.0070;ESCO.0722.00269.0070i_04648;6098;6298;200
ESCO.0722.00269;ESCO.0722.00269.0084;ESCO.0722.00269.0084b_04712;3;1133;1130
ESCO.0722.00269;ESCO.0722.00269.0187;ESCO.0722.00269.0187b_04872;3;209;206
ESCO.0722.00269;ESCO.0722.00269.0028;ESCO.0722.00269.0028i_03249;57366;63707;6341
ESCO.0722.00269;ESCO.0722.00269.0085;ESCO.0722.00269.0085i_04721;3838;4011;173
ESCO.0722.00269;ESCO.0722.00269.0156;ESCO.0722.00269.0156b_04849;2;268;266
ESCO.0722.00269;ESCO.0722.00269.0028;ESCO.0722.00269.0028i_03250;63707;68632;4925
ESCO.0722.00269;ESCO.0722.00269.0050;ESCO.0722.00269.0050i_04306;2081;2587;506
ESCO.0722.00269;ESCO.0722.00269.0069;ESCO.0722.00269.0069b_04626;97;540;443
ESCO.0722.00269;ESCO.0722.00269.0021;ESCO.0722.00269.0021i_02658;19887;20750;863
ESCO.0722.00269;ESCO.0722.00269.0009;ESCO.0722.00269.0009i_01343;48667;49122;455
ESCO.0722.00269;ESCO.0722.00269.0012;ESCO.0722.00269.0012i_01855;198731;200152;1421
ESCO.0722.00269;ESCO.0722.00269.0014;ESCO.0722.00269.0014b_01919;1;378;377
ESCO.0722.00269;ESCO.0722.00269.0036;ESCO.0722.00269.0036i_03775;40887;41177;290
ESCO.0722.00269;ESCO.0722.00269.0050;ESCO.0722.00269.0050i_04319;14606;15019;413
ESCO.0722.00269;ESCO.0722.00269.0052;ESCO.0722.00269.0052b_04383;52;222;170
ESCO.0722.00269;ESCO.0722.00269.0074;ESCO.0722.00269.0074i_04671;620;1060;440
ESCO.0722.00269;ESCO.0722.00269.0088;ESCO.0722.00269.0088b_04735;3844;4068;224
ESCO.0722.00269;ESCO.0722.00269.0175;ESCO.0722.00269.0175b_04863;1;87;86
ESCO.0722.00269;ESCO.0722.00269.0012;ESCO.0722.00269.0012i_01856;200149;200949;800
ESCO.0722.00269;ESCO.0722.00269.0028;ESCO.0722.00269.0028b_03264;91104;91316;212
ESCO.0722.00269;ESCO.0722.00269.0036;ESCO.0722.00269.0036i_03776;41167;41409;242
ESCO.0722.00269;ESCO.0722.00269.0050;ESCO.0722.00269.0050i_04320;15016;15318;302
ESCO.0722.00269;ESCO.0722.00269.0074;ESCO.0722.00269.0074i_04672;1805;1954;149
ESCO.0722.00269;ESCO.0722.00269.0176;ESCO.0722.00269.0176b_04864;3;230;227
ESCO.0722.00270;ESCO.0722.00270.0002;ESCO.0722.00270.0002i_00494;208600;210252;1652
ESCO.0722.00270;ESCO.0722.00270.0003;ESCO.0722.00270.0003i_00750;224611;225171;560
ESCO.0722.00270;ESCO.0722.00270.0009;ESCO.0722.00270.0009i_01550;2592;3680;1088
ESCO.0722.00270;ESCO.0722.00270.0010;ESCO.0722.00270.0010i_01710;1764;3263;1499
ESCO.0722.00270;ESCO.0722.00270.0020;ESCO.0722.00270.0020i_02830;45438;46550;1112
ESCO.0722.00270;ESCO.0722.00270.0045;ESCO.0722.00270.0045i_04014;3544;4737;1193
ESCO.0722.00270;ESCO.0722.00270.0055;ESCO.0722.00270.0055i_04302;26425;27063;638
ESCO.0722.00270;ESCO.0722.00270.0064;ESCO.0722.00270.0064i_04462;9013;9717;704
ESCO.0722.00270;ESCO.0722.00270.0103;ESCO.0722.00270.0103b_04622;1192;1365;173
ESCO.0722.00270;ESCO.0722.00270.0200;ESCO.0722.00270.0200b_04718;2;151;149
ESCO.0722.00270;ESCO.0722.00270.0003;ESCO.0722.00270.0003b_00541;1;771;770
ESCO.0722.00270;ESCO.0722.00270.0004;ESCO.0722.00270.0004b_00989;216987;217085;98
ESCO.0722.00270;ESCO.0722.00270.0011;ESCO.0722.00270.0011i_01981;126970;127725;755
ESCO.0722.00270;ESCO.0722.00270.0014;ESCO.0722.00270.0014b_02269;19977;20117;140
ESCO.0722.00270;ESCO.0722.00270.0020;ESCO.0722.00270.0020b_02877;91142;91717;575
ESCO.0722.00270;ESCO.0722.00270.0024;ESCO.0722.00270.0024b_03133;334;471;137
ESCO.0722.00270;ESCO.0722.00270.0038;ESCO.0722.00270.0038i_03773;5718;6623;905
ESCO.0722.00270;ESCO.0722.00270.0061;ESCO.0722.00270.0061b_04413;13245;13652;407
ESCO.0722.00270;ESCO.0722.00270.0063;ESCO.0722.00270.0063i_04445;5564;7681;2117
ESCO.0722.00270;ESCO.0722.00270.0083;ESCO.0722.00270.0083b_04573;3577;3669;92
ESCO.0722.00270;ESCO.0722.00270.0225;ESCO.0722.00270.0225b_04733;1;99;98
ESCO.0722.00270;ESCO.0722.00270.0024;ESCO.0722.00270.0024i_03134;547;909;362
ESCO.0722.00270;ESCO.0722.00270.0024;ESCO.0722.00270.0024i_03166;23045;25633;2588
ESCO.0722.00270;ESCO.0722.00270.0029;ESCO.0722.00270.0029i_03422;17095;17229;134
ESCO.0722.00270;ESCO.0722.00270.0038;ESCO.0722.00270.0038i_03774;6990;7241;251
ESCO.0722.00270;ESCO.0722.00270.0063;ESCO.0722.00270.0063i_04446;7702;8892;1190
ESCO.0722.00270;ESCO.0722.00270.0024;ESCO.0722.00270.0024i_03135;906;1838;932
ESCO.0722.00270;ESCO.0722.00270.0033;ESCO.0722.00270.0033i_03583;7793;8542;749
ESCO.0722.00270;ESCO.0722.00270.0036;ESCO.0722.00270.0036i_03711;36019;37587;1568
ESCO.0722.00270;ESCO.0722.00270.0038;ESCO.0722.00270.0038i_03775;7312;8586;1274
ESCO.0722.00270;ESCO.0722.00270.0063;ESCO.0722.00270.0063i_04447;8898;10928;2030
ESCO.0722.00270;ESCO.0722.00270.0084;ESCO.0722.00270.0084b_04575;3026;3631;605
ESCO.0722.00270;ESCO.0722.00270.0174;ESCO.0722.00270.0174b_04703;2;241;239
ESCO.0722.00270;ESCO.0722.00270.0229;ESCO.0722.00270.0229b_04735;3;95;92
ESCO.0722.00270;ESCO.0722.00270.0009;ESCO.0722.00270.0009i_01555;6789;7925;1136
ESCO.0722.00270;ESCO.0722.00270.0033;ESCO.0722.00270.0033b_03571;53;163;110
ESCO.0722.00270;ESCO.0722.00270.0035;ESCO.0722.00270.0035i_03667;6211;7122;911
ESCO.0722.00270;ESCO.0722.00270.0052;ESCO.0722.00270.0052b_04243;28602;29117;515
ESCO.0722.00270;ESCO.0722.00270.0056;ESCO.0722.00270.0056i_04307;1688;1984;296
ESCO.0722.00270;ESCO.0722.00270.0061;ESCO.0722.00270.0061i_04403;4746;5498;752
ESCO.0722.00270;ESCO.0722.00270.0068;ESCO.0722.00270.0068i_04499;6553;7119;566
ESCO.0722.00270;ESCO.0722.00270.0009;ESCO.0722.00270.0009i_01556;7935;8819;884
ESCO.0722.00270;ESCO.0722.00270.0025;ESCO.0722.00270.0025b_03284;71658;72464;806
ESCO.0722.00270;ESCO.0722.00270.0027;ESCO.0722.00270.0027b_03348;65806;66708;902
ESCO.0722.00270;ESCO.0722.00270.0028;ESCO.0722.00270.0028i_03380;28514;28663;149
ESCO.0722.00270;ESCO.0722.00270.0033;ESCO.0722.00270.0033i_03572;596;1477;881
ESCO.0722.00270;ESCO.0722.00270.0035;ESCO.0722.00270.0035i_03668;7503;7745;242
ESCO.0722.00270;ESCO.0722.00270.0061;ESCO.0722.00270.0061i_04404;5740;6612;872
ESCO.0722.00270;ESCO.0722.00270.0131;ESCO.0722.00270.0131b_04660;3;500;497
ESCO.0722.00270;ESCO.0722.00270.0003;ESCO.0722.00270.0003i_00748;223952;224281;329
ESCO.0722.00270;ESCO.0722.00270.0005;ESCO.0722.00270.0005i_01068;89813;90586;773
ESCO.0722.00270;ESCO.0722.00270.0005;ESCO.0722.00270.0005i_01100;119986;120324;338
ESCO.0722.00270;ESCO.0722.00270.0009;ESCO.0722.00270.0009b_01548;98;1522;1424
ESCO.0722.00270;ESCO.0722.00270.0017;ESCO.0722.00270.0017i_02508;14076;15215;1139
ESCO.0722.00270;ESCO.0722.00270.0021;ESCO.0722.00270.0021i_02892;15796;16614;818
ESCO.0722.00270;ESCO.0722.00270.0047;ESCO.0722.00270.0047b_04108;30835;31041;206
ESCO.0722.00270;ESCO.0722.00270.0057;ESCO.0722.00270.0057i_04332;3050;3247;197
ESCO.0722.00270;ESCO.0722.00270.0060;ESCO.0722.00270.0060b_04396;15087;15179;92
ESCO.0722.00270;ESCO.0722.00270.0001;ESCO.0722.00270.0001i_00070;67586;68359;773
ESCO.0722.00270;ESCO.0722.00270.0017;ESCO.0722.00270.0017i_02502;10247;10687;440
ESCO.0722.00270;ESCO.0722.00270.0021;ESCO.0722.00270.0021i_02950;75430;75720;290
ESCO.0722.00270;ESCO.0722.00270.0024;ESCO.0722.00270.0024i_03142;4921;5418;497
ESCO.0722.00270;ESCO.0722.00270.0024;ESCO.0722.00270.0024i_03174;30633;31205;572
ESCO.0722.00270;ESCO.0722.00270.0049;ESCO.0722.00270.0049b_04166;29630;30067;437
ESCO.0722.00270;ESCO.0722.00270.0062;ESCO.0722.00270.0062i_04422;4183;4317;134
ESCO.0722.00270;ESCO.0722.00270.0148;ESCO.0722.00270.0148b_04678;1;354;353
ESCO.0722.00270;ESCO.0722.00270.0017;ESCO.0722.00270.0017i_02503;10660;10950;290
ESCO.0722.00270;ESCO.0722.00270.0019;ESCO.0722.00270.0019i_02791;101185;102093;908
ESCO.0722.00270;ESCO.0722.00270.0040;ESCO.0722.00270.0040b_03847;28;123;95
ESCO.0722.00270;ESCO.0722.00270.0040;ESCO.0722.00270.0040b_03879;40285;41961;1676
ESCO.0722.00270;ESCO.0722.00270.0056;ESCO.0722.00270.0056b_04327;19764;20909;1145
ESCO.0722.00270;ESCO.0722.00270.0062;ESCO.0722.00270.0062i_04423;4471;4632;161
ESCO.0722.00270;ESCO.0722.00270.0078;ESCO.0722.00270.0078b_04551;3725;4324;599
ESCO.0722.00270;ESCO.0722.00270.0182;ESCO.0722.00270.0182b_04711;3;203;200
ESCO.0722.00270;ESCO.0722.00270.0017;ESCO.0722.00270.0017i_02504;11196;11558;362
ESCO.0722.00270;ESCO.0722.00270.0018;ESCO.0722.00270.0018i_02696;103086;104150;1064
ESCO.0722.00270;ESCO.0722.00270.0019;ESCO.0722.00270.0019b_02792;102090;102686;596
ESCO.0722.00270;ESCO.0722.00270.0038;ESCO.0722.00270.0038i_03784;16623;16781;158
ESCO.0722.00270;ESCO.0722.00270.0149;ESCO.0722.00270.0149b_04680;250;354;104
ESCO.0722.00270;ESCO.0722.00270.0244;ESCO.0722.00270.0244b_04744;3;65;62
ESCO.0722.00270;ESCO.0722.00270.0001;ESCO.0722.00270.0001i_00067;64684;64992;308
ESCO.0722.00270;ESCO.0722.00270.0024;ESCO.0722.00270.0024i_03139;2989;3873;884
ESCO.0722.00270;ESCO.0722.00270.0024;ESCO.0722.00270.0024i_03171;28702;29061;359
ESCO.0722.00270;ESCO.0722.00270.0024;ESCO.0722.00270.0024i_03203;60994;61554;560
ESCO.0722.00270;ESCO.0722.00270.0033;ESCO.0722.00270.0033i_03587;9781;10005;224
ESCO.0722.00270;ESCO.0722.00270.0178;ESCO.0722.00270.0178b_04707;2;208;206
ESCO.0722.00270;ESCO.0722.00270.0234;ESCO.0722.00270.0234b_04739;3;89;86
ESCO.0722.00270;ESCO.0722.00270.0004;ESCO.0722.00270.0004i_00836;62972;63553;581
ESCO.0722.00270;ESCO.0722.00270.0017;ESCO.0722.00270.0017i_02500;8639;10030;1391
ESCO.0722.00270;ESCO.0722.00270.0024;ESCO.0722.00270.0024i_03172;29132;29533;401
ESCO.0722.00270;ESCO.0722.00270.0033;ESCO.0722.00270.0033i_03588;10087;10305;218
ESCO.0722.00270;ESCO.0722.00270.0056;ESCO.0722.00270.0056i_04324;17845;18627;782
ESCO.0722.00270;ESCO.0722.00270.0178;ESCO.0722.00270.0178b_04708;166;234;68
ESCO.0722.00270;ESCO.0722.00270.0004;ESCO.0722.00270.0004i_00837;63593;63715;122
ESCO.0722.00270;ESCO.0722.00270.0017;ESCO.0722.00270.0017i_02501;10033;10266;233
ESCO.0722.00270;ESCO.0722.00270.0021;ESCO.0722.00270.0021i_02949;74938;75429;491
ESCO.0722.00270;ESCO.0722.00270.0024;ESCO.0722.00270.0024i_03173;29860;30720;860
ESCO.0722.00270;ESCO.0722.00270.0033;ESCO.0722.00270.0033i_03589;10456;11331;875
ESCO.0722.00270;ESCO.0722.00270.0040;ESCO.0722.00270.0040i_03877;37240;38796;1556
ESCO.0722.00270;ESCO.0722.00270.0051;ESCO.0722.00270.0051b_04197;51;551;500
ESCO.0722.00270;ESCO.0722.00270.0179;ESCO.0722.00270.0179b_04709;2;229;227
ESCO.0722.00270;ESCO.0722.00270.0003;ESCO.0722.00270.0003i_00749;224326;224418;92
ESCO.0722.00270;ESCO.0722.00270.0005;ESCO.0722.00270.0005i_01069;90655;91290;635
ESCO.0722.00270;ESCO.0722.00270.0009;ESCO.0722.00270.0009i_01549;1528;2274;746
ESCO.0722.00270;ESCO.0722.00270.0010;ESCO.0722.00270.0010i_01709;1021;1767;746
ESCO.0722.00270;ESCO.0722.00270.0021;ESCO.0722.00270.0021i_02893;16780;17280;500
ESCO.0722.00270;ESCO.0722.00270.0054;ESCO.0722.00270.0054b_04269;14982;15425;443
ESCO.0722.00270;ESCO.0722.00270.0057;ESCO.0722.00270.0057i_04333;3256;3819;563
ESCO.0722.00270;ESCO.0722.00270.0064;ESCO.0722.00270.0064i_04461;8701;8844;143
ESCO.0722.00270;ESCO.0722.00270.0080;ESCO.0722.00270.0080i_04557;1365;1739;374
ESCO.0722.00270;ESCO.0722.00270.0103;ESCO.0722.00270.0103b_04621;2;1192;1190
ESCO.0722.00270;ESCO.0722.00270.0009;ESCO.0722.00270.0009i_01560;11937;12539;602
ESCO.0722.00270;ESCO.0722.00270.0016;ESCO.0722.00270.0016i_02424;35252;35437;185
ESCO.0722.00270;ESCO.0722.00270.0023;ESCO.0722.00270.0023i_03128;80656;81081;425
ESCO.0722.00270;ESCO.0722.00270.0024;ESCO.0722.00270.0024i_03192;45640;46089;449
ESCO.0722.00270;ESCO.0722.00270.0030;ESCO.0722.00270.0030i_03512;51001;51933;932
ESCO.0722.00270;ESCO.0722.00270.0033;ESCO.0722.00270.0033i_03576;2828;3214;386
ESCO.0722.00270;ESCO.0722.00270.0034;ESCO.0722.00270.0034i_03640;23927;24820;893
ESCO.0722.00270;ESCO.0722.00270.0057;ESCO.0722.00270.0057i_04344;12842;14707;1865
ESCO.0722.00270;ESCO.0722.00270.0061;ESCO.0722.00270.0061i_04408;9758;10864;1106
ESCO.0722.00270;ESCO.0722.00270.0164;ESCO.0722.00270.0164b_04696;3;281;278
ESCO.0722.00270;ESCO.0722.00270.0002;ESCO.0722.00270.0002i_00505;219438;220373;935
ESCO.0722.00270;ESCO.0722.00270.0024;ESCO.0722.00270.0024i_03193;46096;46773;677
ESCO.0722.00270;ESCO.0722.00270.0033;ESCO.0722.00270.0033i_03577;3298;3567;269
ESCO.0722.00270;ESCO.0722.00270.0057;ESCO.0722.00270.0057i_04345;14733;17732;2999
ESCO.0722.00270;ESCO.0722.00270.0061;ESCO.0722.00270.0061i_04409;11078;11407;329
ESCO.0722.00270;ESCO.0722.00270.0065;ESCO.0722.00270.0065b_04473;9955;10608;653
ESCO.0722.00270;ESCO.0722.00270.0136;ESCO.0722.00270.0136b_04665;2;124;122
ESCO.0722.00270;ESCO.0722.00270.0002;ESCO.0722.00270.0002i_00506;220385;221329;944
ESCO.0722.00270;ESCO.0722.00270.0003;ESCO.0722.00270.0003i_00602;66048;66461;413
ESCO.0722.00270;ESCO.0722.00270.0033;ESCO.0722.00270.0033i_03578;4225;4323;98
ESCO.0722.00270;ESCO.0722.00270.0061;ESCO.0722.00270.0061i_04410;11437;11775;338
ESCO.0722.00270;ESCO.0722.00270.0063;ESCO.0722.00270.0063i_04442;2197;3342;1145
ESCO.0722.00270;ESCO.0722.00270.0066;ESCO.0722.00270.0066b_04474;1081;3036;1955
ESCO.0722.00270;ESCO.0722.00270.0083;ESCO.0722.00270.0083b_04570;39;2054;2015
ESCO.0722.00270;ESCO.0722.00270.0136;ESCO.0722.00270.0136b_04666;258;401;143
ESCO.0722.00270;ESCO.0722.00270.0166;ESCO.0722.00270.0166b_04698;2;262;260
ESCO.0722.00270;ESCO.0722.00270.0220;ESCO.0722.00270.0220b_04730;2;106;104
ESCO.0722.00270;ESCO.0722.00270.0009;ESCO.0722.00270.0009i_01557;8829;9566;737
ESCO.0722.00270;ESCO.0722.00270.0028;ESCO.0722.00270.0028b_03349;893;1090;197
ESCO.0722.00270;ESCO.0722.00270.0033;ESCO.0722.00270.0033i_03573;1562;2260;698
ESCO.0722.00270;ESCO.0722.00270.0035;ESCO.0722.00270.0035i_03669;8006;8476;470
ESCO.0722.00270;ESCO.0722.00270.0061;ESCO.0722.00270.0061i_04405;6743;7966;1223
ESCO.0722.00270;ESCO.0722.00270.0062;ESCO.0722.00270.0062b_04437;11041;11595;554
ESCO.0722.00270;ESCO.0722.00270.0081;ESCO.0722.00270.0081b_04565;3297;3998;701
ESCO.0722.00270;ESCO.0722.00270.0091;ESCO.0722.00270.0091b_04597;3;1106;1103
ESCO.0722.00270;ESCO.0722.00270.0132;ESCO.0722.00270.0132b_04661;3;488;485
ESCO.0722.00270;ESCO.0722.00270.0009;ESCO.0722.00270.0009i_01558;9544;10731;1187
ESCO.0722.00270;ESCO.0722.00270.0011;ESCO.0722.00270.0011i_01878;13244;13396;152
ESCO.0722.00270;ESCO.0722.00270.0016;ESCO.0722.00270.0016b_02390;1;132;131
ESCO.0722.00270;ESCO.0722.00270.0023;ESCO.0722.00270.0023i_03094;46175;47089;914
ESCO.0722.00270;ESCO.0722.00270.0033;ESCO.0722.00270.0033i_03574;2395;2583;188
ESCO.0722.00270;ESCO.0722.00270.0035;ESCO.0722.00270.0035i_03670;8476;8862;386
ESCO.0722.00270;ESCO.0722.00270.0037;ESCO.0722.00270.0037b_03766;46055;46300;245
ESCO.0722.00270;ESCO.0722.00270.0061;ESCO.0722.00270.0061i_04406;8152;8925;773
ESCO.0722.00270;ESCO.0722.00270.0063;ESCO.0722.00270.0063b_04438;67;804;737
ESCO.0722.00270;ESCO.0722.00270.0009;ESCO.0722.00270.0009i_01559;10724;11944;1220
ESCO.0722.00270;ESCO.0722.00270.0023;ESCO.0722.00270.0023i_03095;47034;48716;1682
ESCO.0722.00270;ESCO.0722.00270.0033;ESCO.0722.00270.0033i_03575;2632;2772;140
ESCO.0722.00270;ESCO.0722.00270.0034;ESCO.0722.00270.0034i_03639;23397;23912;515
ESCO.0722.00270;ESCO.0722.00270.0038;ESCO.0722.00270.0038b_03767;47;982;935
ESCO.0722.00270;ESCO.0722.00270.0061;ESCO.0722.00270.0061i_04407;8991;9692;701
ESCO.0722.00270;ESCO.0722.00270.0063;ESCO.0722.00270.0063i_04439;801;1004;203
ESCO.0722.00270;ESCO.0722.00270.0076;ESCO.0722.00270.0076b_04535;105;1073;968
ESCO.0722.00270;ESCO.0722.00270.0109;ESCO.0722.00270.0109b_04631;1;993;992
ESCO.0722.00270;ESCO.0722.00270.0214;ESCO.0722.00270.0214b_04727;3;110;107
ESCO.0722.00270;ESCO.0722.00270.0033;ESCO.0722.00270.0033i_03584;8594;9010;416
ESCO.0722.00270;ESCO.0722.00270.0036;ESCO.0722.00270.0036i_03712;37633;38904;1271
ESCO.0722.00270;ESCO.0722.00270.0063;ESCO.0722.00270.0063b_04448;10955;11098;143
ESCO.0722.00270;ESCO.0722.00270.0077;ESCO.0722.00270.0077b_04544;4627;4782;155
ESCO.0722.00270;ESCO.0722.00270.0230;ESCO.0722.00270.0230b_04736;3;92;89
ESCO.0722.00270;ESCO.0722.00270.0006;ESCO.0722.00270.0006b_01185;31682;31765;83
ESCO.0722.00270;ESCO.0722.00270.0024;ESCO.0722.00270.0024i_03201;58804;60108;1304
ESCO.0722.00270;ESCO.0722.00270.0078;ESCO.0722.00270.0078b_04545;2;142;140
ESCO.0722.00270;ESCO.0722.00270.0115;ESCO.0722.00270.0115b_04641;2;760;758
ESCO.0722.00270;ESCO.0722.00270.0031;ESCO.0722.00270.0031b_03522;50;361;311
ESCO.0722.00270;ESCO.0722.00270.0144;ESCO.0722.00270.0144b_04674;234;359;125
ESCO.0722.00270;ESCO.0722.00270.0177;ESCO.0722.00270.0177b_04706;21;233;212
ESCO.0722.00270;ESCO.0722.00270.0232;ESCO.0722.00270.0232b_04738;2;88;86
ESCO.0722.00270;ESCO.0722.00270.0003;ESCO.0722.00270.0003i_00747;222614;222946;332
ESCO.0722.00270;ESCO.0722.00270.0005;ESCO.0722.00270.0005i_01067;88667;89179;512
ESCO.0722.00270;ESCO.0722.00270.0005;ESCO.0722.00270.0005i_01099;119563;119955;392
ESCO.0722.00270;ESCO.0722.00270.0014;ESCO.0722.00270.0014b_02251;2;1423;1421
ESCO.0722.00270;ESCO.0722.00270.0047;ESCO.0722.00270.0047i_04107;30698;30838;140
ESCO.0722.00270;ESCO.0722.00270.0101;ESCO.0722.00270.0101b_04619;3;1514;1511
ESCO.0722.00270;ESCO.0722.00270.0192;ESCO.0722.00270.0192b_04715;2;205;203
ESCO.0722.00270;ESCO.0722.00270.0002;ESCO.0722.00270.0002i_00495;210543;213194;2651
ESCO.0722.00270;ESCO.0722.00270.0003;ESCO.0722.00270.0003i_00751;225185;226030;845
ESCO.0722.00270;ESCO.0722.00270.0009;ESCO.0722.00270.0009i_01551;3686;4147;461
ESCO.0722.00270;ESCO.0722.00270.0011;ESCO.0722.00270.0011i_01903;44788;45084;296
ESCO.0722.00270;ESCO.0722.00270.0020;ESCO.0722.00270.0020i_02831;46629;47108;479
ESCO.0722.00270;ESCO.0722.00270.0028;ESCO.0722.00270.0028b_03407;63312;63479;167
ESCO.0722.00270;ESCO.0722.00270.0055;ESCO.0722.00270.0055b_04303;27339;27449;110
ESCO.0722.00270;ESCO.0722.00270.0064;ESCO.0722.00270.0064b_04463;10000;10773;773
ESCO.0722.00270;ESCO.0722.00270.0002;ESCO.0722.00270.0002i_00496;213704;214069;365
ESCO.0722.00270;ESCO.0722.00270.0003;ESCO.0722.00270.0003i_00752;226091;226585;494
ESCO.0722.00270;ESCO.0722.00270.0009;ESCO.0722.00270.0009i_01552;4150;5115;965
ESCO.0722.00270;ESCO.0722.00270.0037;ESCO.0722.00270.0037i_03728;734;3100;2366
ESCO.0722.00270;ESCO.0722.00270.0061;ESCO.0722.00270.0061i_04400;2801;3370;569
ESCO.0722.00270;ESCO.0722.00270.0062;ESCO.0722.00270.0062i_04432;8559;9011;452
ESCO.0722.00270;ESCO.0722.00270.0156;ESCO.0722.00270.0156b_04688;3;308;305
ESCO.0722.00270;ESCO.0722.00270.0003;ESCO.0722.00270.0003i_00753;226733;227290;557
ESCO.0722.00270;ESCO.0722.00270.0024;ESCO.0722.00270.0024i_03217;71021;71605;584
ESCO.0722.00270;ESCO.0722.00270.0037;ESCO.0722.00270.0037i_03729;3039;3227;188
ESCO.0722.00270;ESCO.0722.00270.0061;ESCO.0722.00270.0061i_04401;3472;4191;719
ESCO.0722.00270;ESCO.0722.00270.0062;ESCO.0722.00270.0062i_04433;9008;9568;560
ESCO.0722.00270;ESCO.0722.00270.0009;ESCO.0722.00270.0009i_01554;6248;6799;551
ESCO.0722.00270;ESCO.0722.00270.0024;ESCO.0722.00270.0024b_03218;71606;71710;104
ESCO.0722.00270;ESCO.0722.00270.0061;ESCO.0722.00270.0061i_04402;4173;4388;215
ESCO.0722.00270;ESCO.0722.00270.0062;ESCO.0722.00270.0062i_04434;9825;10016;191
ESCO.0722.00270;ESCO.0722.00270.0127;ESCO.0722.00270.0127b_04658;3;332;329
ESCO.0722.00270;ESCO.0722.00270.0001;ESCO.0722.00270.0001i_00059;59511;60035;524
ESCO.0722.00270;ESCO.0722.00270.0003;ESCO.0722.00270.0003i_00603;66576;67457;881
ESCO.0722.00270;ESCO.0722.00270.0015;ESCO.0722.00270.0015i_02299;32366;32890;524
ESCO.0722.00270;ESCO.0722.00270.0017;ESCO.0722.00270.0017b_02587;108309;108635;326
ESCO.0722.00270;ESCO.0722.00270.0030;ESCO.0722.00270.0030i_03515;55122;56102;980
ESCO.0722.00270;ESCO.0722.00270.0033;ESCO.0722.00270.0033i_03579;4920;5657;737
ESCO.0722.00270;ESCO.0722.00270.0038;ESCO.0722.00270.0038i_03771;4518;4862;344
ESCO.0722.00270;ESCO.0722.00270.0046;ESCO.0722.00270.0046i_04059;17472;17660;188
ESCO.0722.00270;ESCO.0722.00270.0058;ESCO.0722.00270.0058b_04347;29;235;206
ESCO.0722.00270;ESCO.0722.00270.0061;ESCO.0722.00270.0061i_04411;11780;12361;581
ESCO.0722.00270;ESCO.0722.00270.0063;ESCO.0722.00270.0063i_04443;3429;4160;731
ESCO.0722.00270;ESCO.0722.00270.0066;ESCO.0722.00270.0066i_04475;3033;4154;1121
ESCO.0722.00270;ESCO.0722.00270.0077;ESCO.0722.00270.0077b_04539;2;2185;2183
ESCO.0722.00270;ESCO.0722.00270.0221;ESCO.0722.00270.0221b_04731;3;107;104
ESCO.0722.00270;ESCO.0722.00270.0005;ESCO.0722.00270.0005i_01084;106218;108005;1787
ESCO.0722.00270;ESCO.0722.00270.0011;ESCO.0722.00270.0011i_01980;126509;126880;371
ESCO.0722.00270;ESCO.0722.00270.0017;ESCO.0722.00270.0017i_02556;73501;74784;1283
ESCO.0722.00270;ESCO.0722.00270.0023;ESCO.0722.00270.0023b_03132;84289;84474;185
ESCO.0722.00270;ESCO.0722.00270.0033;ESCO.0722.00270.0033i_03580;5682;6473;791
ESCO.0722.00270;ESCO.0722.00270.0038;ESCO.0722.00270.0038i_03772;4874;5728;854
ESCO.0722.00270;ESCO.0722.00270.0061;ESCO.0722.00270.0061i_04412;12503;13060;557
ESCO.0722.00270;ESCO.0722.00270.0063;ESCO.0722.00270.0063i_04444;4150;5559;1409
ESCO.0722.00270;ESCO.0722.00270.0112;ESCO.0722.00270.0112b_04636;50;538;488
ESCO.0722.00270;ESCO.0722.00270.0119;ESCO.0722.00270.0119b_04649;559;696;137
ESCO.0722.00270;ESCO.0722.00270.0003;ESCO.0722.00270.0003i_00746;220571;222481;1910
ESCO.0722.00270;ESCO.0722.00270.0007;ESCO.0722.00270.0007i_01322;152666;152863;197
ESCO.0722.00270;ESCO.0722.00270.0013;ESCO.0722.00270.0013b_02250;110016;110462;446
ESCO.0722.00270;ESCO.0722.00270.0055;ESCO.0722.00270.0055i_04298;24003;24371;368
ESCO.0722.00270;ESCO.0722.00270.0072;ESCO.0722.00270.0072b_04522;19;840;821
ESCO.0722.00270;ESCO.0722.00270.0120;ESCO.0722.00270.0120b_04650;390;692;302
ESCO.0722.00270;ESCO.0722.00270.0150;ESCO.0722.00270.0150b_04682;260;349;89
ESCO.0722.00270;ESCO.0722.00270.0191;ESCO.0722.00270.0191b_04714;1;207;206
ESCO.0722.00277;ESCO.0722.00277.0005;ESCO.0722.00277.0005i_00870;58982;59194;212
ESCO.0722.00277;ESCO.0722.00277.0013;ESCO.0722.00277.0013b_01574;163409;163498;89
ESCO.0722.00277;ESCO.0722.00277.0064;ESCO.0722.00277.0064i_04070;13822;15153;1331
ESCO.0722.00277;ESCO.0722.00277.0078;ESCO.0722.00277.0078i_04198;1621;2553;932
ESCO.0722.00277;ESCO.0722.00277.0139;ESCO.0722.00277.0139b_04262;146;229;83
ESCO.0722.00277;ESCO.0722.00277.0001;ESCO.0722.00277.0001i_00053;53880;54230;350
ESCO.0722.00277;ESCO.0722.00277.0005;ESCO.0722.00277.0005i_00853;42817;44520;1703
ESCO.0722.00277;ESCO.0722.00277.0015;ESCO.0722.00277.0015i_01877;142960;143247;287
ESCO.0722.00277;ESCO.0722.00277.0022;ESCO.0722.00277.0022i_02453;6586;6831;245
ESCO.0722.00277;ESCO.0722.00277.0049;ESCO.0722.00277.0049i_03733;4847;5875;1028
ESCO.0722.00277;ESCO.0722.00277.0052;ESCO.0722.00277.0052b_03829;124;405;281
ESCO.0722.00277;ESCO.0722.00277.0052;ESCO.0722.00277.0052b_03861;31503;31583;80
ESCO.0722.00277;ESCO.0722.00277.0160;ESCO.0722.00277.0160b_04277;3;218;215
ESCO.0722.00277;ESCO.0722.00277.0005;ESCO.0722.00277.0005i_00854;44802;45002;200
ESCO.0722.00277;ESCO.0722.00277.0022;ESCO.0722.00277.0022i_02454;6812;7939;1127
ESCO.0722.00277;ESCO.0722.00277.0024;ESCO.0722.00277.0024i_02582;20985;22799;1814
ESCO.0722.00277;ESCO.0722.00277.0055;ESCO.0722.00277.0055i_03926;9796;10134;338
ESCO.0722.00277;ESCO.0722.00277.0162;ESCO.0722.00277.0162b_04278;1;213;212
ESCO.0722.00277;ESCO.0722.00277.0001;ESCO.0722.00277.0001i_00023;30820;30987;167
ESCO.0722.00277;ESCO.0722.00277.0005;ESCO.0722.00277.0005i_00855;45078;45671;593
ESCO.0722.00277;ESCO.0722.00277.0022;ESCO.0722.00277.0022i_02455;8030;8923;893
ESCO.0722.00277;ESCO.0722.00277.0036;ESCO.0722.00277.0036b_03287;54226;57549;3323
ESCO.0722.00277;ESCO.0722.00277.0049;ESCO.0722.00277.0049i_03735;6689;6952;263
ESCO.0722.00277;ESCO.0722.00277.0164;ESCO.0722.00277.0164b_04279;2;211;209
ESCO.0722.00277;ESCO.0722.00277.0022;ESCO.0722.00277.0022i_02443;696;1445;749
ESCO.0722.00277;ESCO.0722.00277.0069;ESCO.0722.00277.0069i_04139;328;678;350
ESCO.0722.00277;ESCO.0722.00277.0146;ESCO.0722.00277.0146b_04267;27;224;197
ESCO.0722.00277;ESCO.0722.00277.0022;ESCO.0722.00277.0022i_02444;1414;1887;473
ESCO.0722.00277;ESCO.0722.00277.0069;ESCO.0722.00277.0069i_04140;772;1914;1142
ESCO.0722.00277;ESCO.0722.00277.0147;ESCO.0722.00277.0147b_04268;58;222;164
ESCO.0722.00277;ESCO.0722.00277.0005;ESCO.0722.00277.0005i_00868;56665;57291;626
ESCO.0722.00277;ESCO.0722.00277.0020;ESCO.0722.00277.0020i_02308;44392;44952;560
ESCO.0722.00277;ESCO.0722.00277.0024;ESCO.0722.00277.0024i_02596;38381;38683;302
ESCO.0722.00277;ESCO.0722.00277.0028;ESCO.0722.00277.0028i_02852;3666;4649;983
ESCO.0722.00277;ESCO.0722.00277.0064;ESCO.0722.00277.0064i_04068;12767;13207;440
ESCO.0722.00277;ESCO.0722.00277.0078;ESCO.0722.00277.0078b_04196;65;154;89
ESCO.0722.00277;ESCO.0722.00277.0033;ESCO.0722.00277.0033i_03070;1601;2191;590
ESCO.0722.00277;ESCO.0722.00277.0058;ESCO.0722.00277.0058i_03998;3791;4231;440
ESCO.0722.00277;ESCO.0722.00277.0068;ESCO.0722.00277.0068i_04126;4507;4974;467
ESCO.0722.00277;ESCO.0722.00277.0171;ESCO.0722.00277.0171b_04286;2;205;203
ESCO.0722.00277;ESCO.0722.00277.0005;ESCO.0722.00277.0005i_00863;50483;50854;371
ESCO.0722.00277;ESCO.0722.00277.0033;ESCO.0722.00277.0033i_03071;2172;3164;992
ESCO.0722.00277;ESCO.0722.00277.0058;ESCO.0722.00277.0058i_03999;4348;5673;1325
ESCO.0722.00277;ESCO.0722.00277.0068;ESCO.0722.00277.0068i_04127;5051;5290;239
ESCO.0722.00277;ESCO.0722.00277.0129;ESCO.0722.00277.0129b_04255;3;242;239
ESCO.0722.00277;ESCO.0722.00277.0172;ESCO.0722.00277.0172b_04287;2;115;113
ESCO.0722.00277;ESCO.0722.00277.0001;ESCO.0722.00277.0001i_00064;62625;64121;1496
ESCO.0722.00277;ESCO.0722.00277.0005;ESCO.0722.00277.0005i_00864;50847;51920;1073
ESCO.0722.00277;ESCO.0722.00277.0014;ESCO.0722.00277.0014i_01664;94468;94953;485
ESCO.0722.00277;ESCO.0722.00277.0020;ESCO.0722.00277.0020i_02304;37455;40175;2720
ESCO.0722.00277;ESCO.0722.00277.0033;ESCO.0722.00277.0033i_03072;3167;4333;1166
ESCO.0722.00277;ESCO.0722.00277.0035;ESCO.0722.00277.0035i_03232;57969;58802;833
ESCO.0722.00277;ESCO.0722.00277.0068;ESCO.0722.00277.0068i_04128;5388;5846;458
ESCO.0722.00277;ESCO.0722.00277.0005;ESCO.0722.00277.0005i_00859;47157;47393;236
ESCO.0722.00277;ESCO.0722.00277.0013;ESCO.0722.00277.0013i_01563;148460;150196;1736
ESCO.0722.00277;ESCO.0722.00277.0037;ESCO.0722.00277.0037i_03291;3248;4039;791
ESCO.0722.00277;ESCO.0722.00277.0058;ESCO.0722.00277.0058i_03995;1872;2570;698
ESCO.0722.00277;ESCO.0722.00277.0070;ESCO.0722.00277.0070b_04155;7714;9174;1460
ESCO.0722.00277;ESCO.0722.00277.0168;ESCO.0722.00277.0168b_04283;3;209;206
ESCO.0722.00277;ESCO.0722.00277.0005;ESCO.0722.00277.0005i_00860;47434;48135;701
ESCO.0722.00277;ESCO.0722.00277.0033;ESCO.0722.00277.0033b_03068;23;496;473
ESCO.0722.00277;ESCO.0722.00277.0037;ESCO.0722.00277.0037i_03292;4036;4272;236
ESCO.0722.00277;ESCO.0722.00277.0058;ESCO.0722.00277.0058i_03996;2597;3451;854
ESCO.0722.00277;ESCO.0722.00277.0169;ESCO.0722.00277.0169b_04284;92;211;119
ESCO.0722.00277;ESCO.0722.00277.0033;ESCO.0722.00277.0033i_03069;498;1616;1118
ESCO.0722.00277;ESCO.0722.00277.0058;ESCO.0722.00277.0058i_03997;3570;3794;224
ESCO.0722.00277;ESCO.0722.00277.0068;ESCO.0722.00277.0068i_04125;3627;4484;857
ESCO.0722.00277;ESCO.0722.00277.0170;ESCO.0722.00277.0170b_04285;3;209;206
ESCO.0722.00277;ESCO.0722.00277.0004;ESCO.0722.00277.0004b_00645;396;668;272
ESCO.0722.00277;ESCO.0722.00277.0005;ESCO.0722.00277.0005i_00869;57444;58853;1409
ESCO.0722.00277;ESCO.0722.00277.0020;ESCO.0722.00277.0020i_02309;45001;45312;311
ESCO.0722.00277;ESCO.0722.00277.0028;ESCO.0722.00277.0028i_02853;4774;5310;536
ESCO.0722.00277;ESCO.0722.00277.0042;ESCO.0722.00277.0042b_03525;41756;42334;578
ESCO.0722.00277;ESCO.0722.00277.0064;ESCO.0722.00277.0064i_04069;13179;13481;302
ESCO.0722.00277;ESCO.0722.00277.0068;ESCO.0722.00277.0068i_04133;7382;7486;104
ESCO.0722.00277;ESCO.0722.00277.0078;ESCO.0722.00277.0078i_04197;207;1634;1427
ESCO.0722.00277;ESCO.0722.00277.0139;ESCO.0722.00277.0139b_04261;2;136;134
ESCO.0722.00277;ESCO.0722.00277.0059;ESCO.0722.00277.0059b_04016;1;345;344
ESCO.0722.00277;ESCO.0722.00277.0069;ESCO.0722.00277.0069i_04144;6732;8342;1610
ESCO.0722.00277;ESCO.0722.00277.0102;ESCO.0722.00277.0102b_04240;3;656;653
ESCO.0722.00277;ESCO.0722.00277.0151;ESCO.0722.00277.0151b_04272;2;223;221
ESCO.0722.00277;ESCO.0722.00277.0015;ESCO.0722.00277.0015i_01809;68994;69449;455
ESCO.0722.00277;ESCO.0722.00277.0069;ESCO.0722.00277.0069i_04145;8347;9105;758
ESCO.0722.00277;ESCO.0722.00277.0103;ESCO.0722.00277.0103b_04241;2;592;590
ESCO.0722.00277;ESCO.0722.00277.0152;ESCO.0722.00277.0152b_04273;1;222;221
ESCO.0722.00277;ESCO.0722.00277.0007;ESCO.0722.00277.0007i_01042;7383;7541;158
ESCO.0722.00277;ESCO.0722.00277.0015;ESCO.0722.00277.0015i_01810;69517;69918;401
ESCO.0722.00277;ESCO.0722.00277.0016;ESCO.0722.00277.0016i_01906;18285;19127;842
ESCO.0722.00277;ESCO.0722.00277.0019;ESCO.0722.00277.0019i_02258;28346;28513;167
ESCO.0722.00277;ESCO.0722.00277.0154;ESCO.0722.00277.0154b_04274;3;221;218
ESCO.0722.00277;ESCO.0722.00277.0018;ESCO.0722.00277.0018i_02157;26035;27972;1937
ESCO.0722.00277;ESCO.0722.00277.0038;ESCO.0722.00277.0038b_03341;25296;25523;227
ESCO.0722.00277;ESCO.0722.00277.0069;ESCO.0722.00277.0069i_04141;2221;3129;908
ESCO.0722.00277;ESCO.0722.00277.0148;ESCO.0722.00277.0148b_04269;3;224;221
ESCO.0722.00277;ESCO.0722.00277.0223;ESCO.0722.00277.0223b_04301;3;62;59
ESCO.0722.00277;ESCO.0722.00277.0018;ESCO.0722.00277.0018i_02158;27935;28894;959
ESCO.0722.00277;ESCO.0722.00277.0022;ESCO.0722.00277.0022i_02446;2081;3448;1367
ESCO.0722.00277;ESCO.0722.00277.0039;ESCO.0722.00277.0039b_03342;1;75;74
ESCO.0722.00277;ESCO.0722.00277.0069;ESCO.0722.00277.0069i_04142;3144;5111;1967
ESCO.0722.00277;ESCO.0722.00277.0025;ESCO.0722.00277.0025b_02767;103642;104397;755
ESCO.0722.00277;ESCO.0722.00277.0043;ESCO.0722.00277.0043i_03535;12970;13179;209
ESCO.0722.00277;ESCO.0722.00277.0058;ESCO.0722.00277.0058b_04015;23009;23896;887
ESCO.0722.00277;ESCO.0722.00277.0069;ESCO.0722.00277.0069i_04143;5338;6720;1382
ESCO.0722.00277;ESCO.0722.00277.0101;ESCO.0722.00277.0101b_04239;3;671;668
ESCO.0722.00277;ESCO.0722.00277.0150;ESCO.0722.00277.0150b_04271;3;221;218
ESCO.0722.00277;ESCO.0722.00277.0001;ESCO.0722.00277.0001i_00024;30988;31377;389
ESCO.0722.00277;ESCO.0722.00277.0005;ESCO.0722.00277.0005i_00856;45684;45998;314
ESCO.0722.00277;ESCO.0722.00277.0006;ESCO.0722.00277.0006i_00952;55882;56196;314
ESCO.0722.00277;ESCO.0722.00277.0022;ESCO.0722.00277.0022i_02456;9390;10085;695
ESCO.0722.00277;ESCO.0722.00277.0085;ESCO.0722.00277.0085b_04216;3;539;536
ESCO.0722.00277;ESCO.0722.00277.0165;ESCO.0722.00277.0165b_04280;1;129;128
ESCO.0722.00277;ESCO.0722.00277.0001;ESCO.0722.00277.0001i_00025;31383;31475;92
ESCO.0722.00277;ESCO.0722.00277.0005;ESCO.0722.00277.0005i_00857;46223;46690;467
ESCO.0722.00277;ESCO.0722.00277.0017;ESCO.0722.00277.0017b_02009;109;1506;1397
ESCO.0722.00277;ESCO.0722.00277.0022;ESCO.0722.00277.0022i_02457;10086;10751;665
ESCO.0722.00277;ESCO.0722.00277.0058;ESCO.0722.00277.0058b_03993;2;883;881
ESCO.0722.00277;ESCO.0722.00277.0166;ESCO.0722.00277.0166b_04281;2;211;209
ESCO.0722.00277;ESCO.0722.00277.0001;ESCO.0722.00277.0001i_00026;31695;32180;485
ESCO.0722.00277;ESCO.0722.00277.0004;ESCO.0722.00277.0004i_00762;128645;128743;98
ESCO.0722.00277;ESCO.0722.00277.0005;ESCO.0722.00277.0005i_00858;46714;47157;443
ESCO.0722.00277;ESCO.0722.00277.0013;ESCO.0722.00277.0013i_01562;147551;148447;896
ESCO.0722.00277;ESCO.0722.00277.0049;ESCO.0722.00277.0049i_03738;9017;9577;560
ESCO.0722.00277;ESCO.0722.00277.0051;ESCO.0722.00277.0051b_03802;14;2572;2558
ESCO.0722.00277;ESCO.0722.00277.0058;ESCO.0722.00277.0058i_03994;974;1600;626
ESCO.0722.00277;ESCO.0722.00277.0068;ESCO.0722.00277.0068i_04122;412;1305;893
ESCO.0722.00277;ESCO.0722.00277.0085;ESCO.0722.00277.0085b_04218;1113;1745;632
ESCO.0722.00277;ESCO.0722.00277.0115;ESCO.0722.00277.0115b_04250;2;313;311
ESCO.0722.00277;ESCO.0722.00277.0167;ESCO.0722.00277.0167b_04282;3;209;206
ESCO.0722.00277;ESCO.0722.00277.0005;ESCO.0722.00277.0005i_00867;54298;56487;2189
ESCO.0722.00277;ESCO.0722.00277.0024;ESCO.0722.00277.0024b_02563;2;115;113
ESCO.0722.00277;ESCO.0722.00277.0033;ESCO.0722.00277.0033i_03075;6688;7245;557
ESCO.0722.00277;ESCO.0722.00277.0036;ESCO.0722.00277.0036b_03235;2;349;347
ESCO.0722.00277;ESCO.0722.00277.0045;ESCO.0722.00277.0045i_03619;465;728;263
ESCO.0722.00277;ESCO.0722.00277.0056;ESCO.0722.00277.0056b_03971;26683;26754;71
ESCO.0722.00277;ESCO.0722.00277.0064;ESCO.0722.00277.0064i_04067;12138;12740;602
ESCO.0722.00277;ESCO.0722.00277.0005;ESCO.0722.00277.0005i_00871;59238;60194;956
ESCO.0722.00277;ESCO.0722.00277.0014;ESCO.0722.00277.0014b_01575;1;402;401
ESCO.0722.00277;ESCO.0722.00277.0022;ESCO.0722.00277.0022i_02503;57906;58571;665
ESCO.0722.00277;ESCO.0722.00277.0141;ESCO.0722.00277.0141b_04263;3;227;224
ESCO.0722.00277;ESCO.0722.00277.0003;ESCO.0722.00277.0003i_00488;89370;90053;683
ESCO.0722.00277;ESCO.0722.00277.0022;ESCO.0722.00277.0022i_02504;58644;58859;215
ESCO.0722.00277;ESCO.0722.00277.0039;ESCO.0722.00277.0039b_03400;53742;54809;1067
ESCO.0722.00277;ESCO.0722.00277.0065;ESCO.0722.00277.0065b_04072;3;422;419
ESCO.0722.00277;ESCO.0722.00277.0078;ESCO.0722.00277.0078b_04200;3720;4082;362
ESCO.0722.00277;ESCO.0722.00277.0142;ESCO.0722.00277.0142b_04264;1;225;224
ESCO.0722.00277;ESCO.0722.00277.0003;ESCO.0722.00277.0003i_00489;90050;90289;239
ESCO.0722.00277;ESCO.0722.00277.0013;ESCO.0722.00277.0013i_01449;24993;25478;485
ESCO.0722.00277;ESCO.0722.00277.0022;ESCO.0722.00277.0022b_02441;1;117;116
ESCO.0722.00277;ESCO.0722.00277.0068;ESCO.0722.00277.0068b_04137;11588;11728;140
ESCO.0722.00277;ESCO.0722.00277.0143;ESCO.0722.00277.0143b_04265;89;226;137
ESCO.0722.00277;ESCO.0722.00277.0198;ESCO.0722.00277.0198b_04297;3;110;107
ESCO.0722.00277;ESCO.0722.00277.0073;ESCO.0722.00277.0073b_04170;2;160;158
ESCO.0722.00277;ESCO.0722.00277.0144;ESCO.0722.00277.0144b_04266;2;226;224
ESCO.0722.00277;ESCO.0722.00277.0201;ESCO.0722.00277.0201b_04298;1;108;107
ESCO.0722.00277;ESCO.0722.00277.0005;ESCO.0722.00277.0005i_00819;8345;9262;917
ESCO.0722.00277;ESCO.0722.00277.0007;ESCO.0722.00277.0007i_01043;7538;8188;650
ESCO.0722.00277;ESCO.0722.00277.0018;ESCO.0722.00277.0018b_02131;22;360;338
ESCO.0722.00277;ESCO.0722.00277.0022;ESCO.0722.00277.0022i_02451;5534;5842;308
ESCO.0722.00277;ESCO.0722.00277.0063;ESCO.0722.00277.0063b_04051;5957;6040;83
ESCO.0722.00277;ESCO.0722.00277.0105;ESCO.0722.00277.0105b_04243;3;524;521
ESCO.0722.00277;ESCO.0722.00277.0158;ESCO.0722.00277.0158b_04275;1;219;218
ESCO.0722.00277;ESCO.0722.00277.0005;ESCO.0722.00277.0005i_00820;9256;9522;266
ESCO.0722.00277;ESCO.0722.00277.0015;ESCO.0722.00277.0015i_01876;142643;143008;365
ESCO.0722.00277;ESCO.0722.00277.0022;ESCO.0722.00277.0022i_02452;5780;6121;341
ESCO.0722.00277;ESCO.0722.00277.0049;ESCO.0722.00277.0049i_03732;4716;4847;131
ESCO.0722.00277;ESCO.0722.00277.0070;ESCO.0722.00277.0070i_04148;1408;1506;98
ESCO.0722.00277;ESCO.0722.00277.0083;ESCO.0722.00277.0083b_04212;1011;2165;1154
ESCO.0722.00277;ESCO.0722.00277.0106;ESCO.0722.00277.0106b_04244;130;432;302
ESCO.0722.00277;ESCO.0722.00277.0159;ESCO.0722.00277.0159b_04276;3;218;215
ESCO.0722.00277;ESCO.0722.00277.0005;ESCO.0722.00277.0005i_00865;52062;52325;263
ESCO.0722.00277;ESCO.0722.00277.0014;ESCO.0722.00277.0014i_01665;94978;96084;1106
ESCO.0722.00277;ESCO.0722.00277.0020;ESCO.0722.00277.0020i_02305;40379;41896;1517
ESCO.0722.00277;ESCO.0722.00277.0024;ESCO.0722.00277.0024i_02625;70141;70467;326
ESCO.0722.00277;ESCO.0722.00277.0033;ESCO.0722.00277.0033i_03073;4333;5436;1103
ESCO.0722.00277;ESCO.0722.00277.0056;ESCO.0722.00277.0056i_03969;25479;25910;431
ESCO.0722.00277;ESCO.0722.00277.0066;ESCO.0722.00277.0066i_04097;10285;10512;227
ESCO.0722.00277;ESCO.0722.00277.0132;ESCO.0722.00277.0132b_04257;3;236;233
ESCO.0722.00277;ESCO.0722.00277.0174;ESCO.0722.00277.0174b_04289;1;192;191
ESCO.0722.00277;ESCO.0722.00277.0005;ESCO.0722.00277.0005i_00866;52685;54301;1616
ESCO.0722.00277;ESCO.0722.00277.0033;ESCO.0722.00277.0033i_03074;5444;6691;1247
ESCO.0722.00277;ESCO.0722.00277.0035;ESCO.0722.00277.0035b_03234;59493;59582;89
ESCO.0722.00277;ESCO.0722.00277.0045;ESCO.0722.00277.0045b_03618;47;142;95
ESCO.0722.00277;ESCO.0722.00277.0056;ESCO.0722.00277.0056i_03970;25965;26708;743
ESCO.0722.00277;ESCO.0722.00277.0066;ESCO.0722.00277.0066i_04098;10509;10799;290
ESCO.0722.00297;ESCO.0722.00297.0002;ESCO.0722.00297.0002i_00601;287817;288335;518
ESCO.0722.00297;ESCO.0722.00297.0015;ESCO.0722.00297.0015i_02585;63381;63560;179
ESCO.0722.00297;ESCO.0722.00297.0015;ESCO.0722.00297.0015i_02617;88127;88264;137
ESCO.0722.00297;ESCO.0722.00297.0018;ESCO.0722.00297.0018i_02777;89454;89951;497
ESCO.0722.00297;ESCO.0722.00297.0018;ESCO.0722.00297.0018i_02809;109176;109595;419
ESCO.0722.00297;ESCO.0722.00297.0029;ESCO.0722.00297.0029i_03705;659;1954;1295
ESCO.0722.00297;ESCO.0722.00297.0148;ESCO.0722.00297.0148b_05113;221;355;134
ESCO.0722.00297;ESCO.0722.00297.0193;ESCO.0722.00297.0193b_05145;2;160;158
ESCO.0722.00297;ESCO.0722.00297.0254;ESCO.0722.00297.0254b_05177;3;71;68
ESCO.0722.00297;ESCO.0722.00297.0001;ESCO.0722.00297.0001i_00136;144567;145040;473
ESCO.0722.00297;ESCO.0722.00297.0015;ESCO.0722.00297.0015i_02600;75692;76051;359
ESCO.0722.00297;ESCO.0722.00297.0015;ESCO.0722.00297.0015i_02632;94331;95731;1400
ESCO.0722.00297;ESCO.0722.00297.0018;ESCO.0722.00297.0018i_02792;96539;97135;596
ESCO.0722.00297;ESCO.0722.00297.0018;ESCO.0722.00297.0018i_02824;118595;118948;353
ESCO.0722.00297;ESCO.0722.00297.0029;ESCO.0722.00297.0029i_03720;11987;13468;1481
ESCO.0722.00297;ESCO.0722.00297.0029;ESCO.0722.00297.0029i_03752;32319;32552;233
ESCO.0722.00297;ESCO.0722.00297.0038;ESCO.0722.00297.0038i_04168;13232;14785;1553
ESCO.0722.00297;ESCO.0722.00297.0167;ESCO.0722.00297.0167b_05128;3;275;272
ESCO.0722.00297;ESCO.0722.00297.0015;ESCO.0722.00297.0015i_02601;76056;76433;377
ESCO.0722.00297;ESCO.0722.00297.0015;ESCO.0722.00297.0015i_02633;95749;95853;104
ESCO.0722.00297;ESCO.0722.00297.0018;ESCO.0722.00297.0018i_02825;118948;120144;1196
ESCO.0722.00297;ESCO.0722.00297.0029;ESCO.0722.00297.0029i_03721;13472;14023;551
ESCO.0722.00297;ESCO.0722.00297.0029;ESCO.0722.00297.0029i_03753;32666;33370;704
ESCO.0722.00297;ESCO.0722.00297.0038;ESCO.0722.00297.0038i_04169;14788;16935;2147
ESCO.0722.00297;ESCO.0722.00297.0052;ESCO.0722.00297.0052i_04553;14185;14436;251
ESCO.0722.00297;ESCO.0722.00297.0069;ESCO.0722.00297.0069i_04905;1358;1450;92
ESCO.0722.00297;ESCO.0722.00297.0003;ESCO.0722.00297.0003i_00714;96054;96551;497
ESCO.0722.00297;ESCO.0722.00297.0003;ESCO.0722.00297.0003i_00906;302861;303175;314
ESCO.0722.00297;ESCO.0722.00297.0015;ESCO.0722.00297.0015i_02602;76435;77484;1049
ESCO.0722.00297;ESCO.0722.00297.0018;ESCO.0722.00297.0018i_02762;82031;83290;1259
ESCO.0722.00297;ESCO.0722.00297.0018;ESCO.0722.00297.0018i_02826;120141;120914;773
ESCO.0722.00297;ESCO.0722.00297.0029;ESCO.0722.00297.0029i_03722;14005;14373;368
ESCO.0722.00297;ESCO.0722.00297.0029;ESCO.0722.00297.0029i_03754;33499;33654;155
ESCO.0722.00297;ESCO.0722.00297.0038;ESCO.0722.00297.0038i_04170;16986;17372;386
ESCO.0722.00297;ESCO.0722.00297.0043;ESCO.0722.00297.0043i_04266;14360;14890;530
ESCO.0722.00297;ESCO.0722.00297.0062;ESCO.0722.00297.0062i_04810;8377;9894;1517
ESCO.0722.00297;ESCO.0722.00297.0002;ESCO.0722.00297.0002i_00606;292248;293081;833
ESCO.0722.00297;ESCO.0722.00297.0006;ESCO.0722.00297.0006i_01214;26446;27003;557
ESCO.0722.00297;ESCO.0722.00297.0015;ESCO.0722.00297.0015i_02590;67251;67700;449
ESCO.0722.00297;ESCO.0722.00297.0015;ESCO.0722.00297.0015i_02622;89753;90001;248
ESCO.0722.00297;ESCO.0722.00297.0018;ESCO.0722.00297.0018i_02782;92525;92818;293
ESCO.0722.00297;ESCO.0722.00297.0018;ESCO.0722.00297.0018i_02814;112178;112621;443
ESCO.0722.00297;ESCO.0722.00297.0029;ESCO.0722.00297.0029i_03710;5167;6036;869
ESCO.0722.00297;ESCO.0722.00297.0044;ESCO.0722.00297.0044b_04286;150;611;461
ESCO.0722.00297;ESCO.0722.00297.0058;ESCO.0722.00297.0058i_04734;5334;7499;2165
ESCO.0722.00297;ESCO.0722.00297.0100;ESCO.0722.00297.0100b_05054;437;613;176
ESCO.0722.00297;ESCO.0722.00297.0154;ESCO.0722.00297.0154b_05118;2;319;317
ESCO.0722.00297;ESCO.0722.00297.0002;ESCO.0722.00297.0002i_00607;293084;294373;1289
ESCO.0722.00297;ESCO.0722.00297.0004;ESCO.0722.00297.0004i_00991;79534;79713;179
ESCO.0722.00297;ESCO.0722.00297.0015;ESCO.0722.00297.0015i_02591;67697;68278;581
ESCO.0722.00297;ESCO.0722.00297.0015;ESCO.0722.00297.0015i_02623;90119;90352;233
ESCO.0722.00297;ESCO.0722.00297.0018;ESCO.0722.00297.0018i_02783;92815;93261;446
ESCO.0722.00297;ESCO.0722.00297.0018;ESCO.0722.00297.0018i_02815;112625;113044;419
ESCO.0722.00297;ESCO.0722.00297.0029;ESCO.0722.00297.0029i_03711;6033;6338;305
ESCO.0722.00297;ESCO.0722.00297.0042;ESCO.0722.00297.0042b_04255;19144;19548;404
ESCO.0722.00297;ESCO.0722.00297.0055;ESCO.0722.00297.0055b_04639;41;772;731
ESCO.0722.00297;ESCO.0722.00297.0058;ESCO.0722.00297.0058i_04735;7576;8493;917
ESCO.0722.00297;ESCO.0722.00297.0100;ESCO.0722.00297.0100i_05055;610;828;218
ESCO.0722.00297;ESCO.0722.00297.0199;ESCO.0722.00297.0199b_05151;3;179;176
ESCO.0722.00297;ESCO.0722.00297.0015;ESCO.0722.00297.0015b_02519;28;1290;1262
ESCO.0722.00297;ESCO.0722.00297.0015;ESCO.0722.00297.0015i_02583;60246;60998;752
ESCO.0722.00297;ESCO.0722.00297.0015;ESCO.0722.00297.0015i_02615;86854;87171;317
ESCO.0722.00297;ESCO.0722.00297.0018;ESCO.0722.00297.0018i_02775;88426;88641;215
ESCO.0722.00297;ESCO.0722.00297.0018;ESCO.0722.00297.0018i_02807;107945;108886;941
ESCO.0722.00297;ESCO.0722.00297.0019;ESCO.0722.00297.0019i_02935;108017;108436;419
ESCO.0722.00297;ESCO.0722.00297.0028;ESCO.0722.00297.0028b_03703;72479;72925;446
ESCO.0722.00297;ESCO.0722.00297.0029;ESCO.0722.00297.0029i_03735;23959;24123;164
ESCO.0722.00297;ESCO.0722.00297.0067;ESCO.0722.00297.0067i_04887;11773;12165;392
ESCO.0722.00297;ESCO.0722.00297.0191;ESCO.0722.00297.0191b_05143;132;215;83
ESCO.0722.00297;ESCO.0722.00297.0246;ESCO.0722.00297.0246b_05175;1;81;80
ESCO.0722.00297;ESCO.0722.00297.0006;ESCO.0722.00297.0006i_01201;13236;13493;257
ESCO.0722.00297;ESCO.0722.00297.0012;ESCO.0722.00297.0012i_02193;32935;34308;1373
ESCO.0722.00297;ESCO.0722.00297.0015;ESCO.0722.00297.0015i_02609;83419;84000;581
ESCO.0722.00297;ESCO.0722.00297.0018;ESCO.0722.00297.0018i_02769;85398;86021;623
ESCO.0722.00297;ESCO.0722.00297.0018;ESCO.0722.00297.0018i_02801;102023;103423;1400
ESCO.0722.00297;ESCO.0722.00297.0019;ESCO.0722.00297.0019i_02929;104170;104706;536
ESCO.0722.00297;ESCO.0722.00297.0021;ESCO.0722.00297.0021i_03089;21059;21370;311
ESCO.0722.00297;ESCO.0722.00297.0029;ESCO.0722.00297.0029i_03729;18398;19096;698
ESCO.0722.00297;ESCO.0722.00297.0049;ESCO.0722.00297.0049b_04465;30409;30732;323
ESCO.0722.00297;ESCO.0722.00297.0072;ESCO.0722.00297.0072i_04945;6104;6289;185
ESCO.0722.00297;ESCO.0722.00297.0076;ESCO.0722.00297.0076b_04977;6288;6632;344
ESCO.0722.00297;ESCO.0722.00297.0093;ESCO.0722.00297.0093b_05041;2610;2669;59
ESCO.0722.00297;ESCO.0722.00297.0111;ESCO.0722.00297.0111b_05073;161;1132;971
ESCO.0722.00297;ESCO.0722.00297.0011;ESCO.0722.00297.0011i_02130;161494;161991;497
ESCO.0722.00297;ESCO.0722.00297.0012;ESCO.0722.00297.0012i_02194;34435;34908;473
ESCO.0722.00297;ESCO.0722.00297.0015;ESCO.0722.00297.0015i_02610;84294;84797;503
ESCO.0722.00297;ESCO.0722.00297.0018;ESCO.0722.00297.0018i_02770;86018;86815;797
ESCO.0722.00297;ESCO.0722.00297.0018;ESCO.0722.00297.0018i_02802;103661;105112;1451
ESCO.0722.00297;ESCO.0722.00297.0019;ESCO.0722.00297.0019i_02930;104711;105250;539
ESCO.0722.00297;ESCO.0722.00297.0024;ESCO.0722.00297.0024i_03378;42240;42764;524
ESCO.0722.00297;ESCO.0722.00297.0027;ESCO.0722.00297.0027i_03634;75134;75259;125
ESCO.0722.00297;ESCO.0722.00297.0029;ESCO.0722.00297.0029i_03730;19149;20669;1520
ESCO.0722.00297;ESCO.0722.00297.0052;ESCO.0722.00297.0052i_04562;19106;19363;257
ESCO.0722.00297;ESCO.0722.00297.0072;ESCO.0722.00297.0072i_04946;7226;7768;542
ESCO.0722.00297;ESCO.0722.00297.0143;ESCO.0722.00297.0143b_05106;61;393;332
ESCO.0722.00297;ESCO.0722.00297.0185;ESCO.0722.00297.0185b_05138;3;224;221
ESCO.0722.00297;ESCO.0722.00297.0008;ESCO.0722.00297.0008i_01651;21588;22502;914
ESCO.0722.00297;ESCO.0722.00297.0011;ESCO.0722.00297.0011i_02131;162009;162407;398
ESCO.0722.00297;ESCO.0722.00297.0012;ESCO.0722.00297.0012i_02195;35221;38121;2900
ESCO.0722.00297;ESCO.0722.00297.0015;ESCO.0722.00297.0015i_02611;84808;85446;638
ESCO.0722.00297;ESCO.0722.00297.0018;ESCO.0722.00297.0018i_02771;86781;87065;284
ESCO.0722.00297;ESCO.0722.00297.0018;ESCO.0722.00297.0018i_02803;105183;105716;533
ESCO.0722.00297;ESCO.0722.00297.0020;ESCO.0722.00297.0020i_03059;108616;108825;209
ESCO.0722.00297;ESCO.0722.00297.0029;ESCO.0722.00297.0029i_03731;20670;22346;1676
ESCO.0722.00297;ESCO.0722.00297.0052;ESCO.0722.00297.0052i_04563;19365;20606;1241
ESCO.0722.00297;ESCO.0722.00297.0072;ESCO.0722.00297.0072i_04947;7781;8641;860
ESCO.0722.00297;ESCO.0722.00297.0186;ESCO.0722.00297.0186b_05139;2;223;221
ESCO.0722.00297;ESCO.0722.00297.0015;ESCO.0722.00297.0015i_02606;79445;81079;1634
ESCO.0722.00297;ESCO.0722.00297.0015;ESCO.0722.00297.0015i_02638;101219;101461;242
ESCO.0722.00297;ESCO.0722.00297.0018;ESCO.0722.00297.0018i_02766;83953;84627;674
ESCO.0722.00297;ESCO.0722.00297.0018;ESCO.0722.00297.0018i_02798;100213;100716;503
ESCO.0722.00297;ESCO.0722.00297.0019;ESCO.0722.00297.0019i_02926;103160;103702;542
ESCO.0722.00297;ESCO.0722.00297.0022;ESCO.0722.00297.0022i_03182;17434;17961;527
ESCO.0722.00297;ESCO.0722.00297.0029;ESCO.0722.00297.0029i_03726;15707;16744;1037
ESCO.0722.00297;ESCO.0722.00297.0072;ESCO.0722.00297.0072i_04942;4452;4802;350
ESCO.0722.00297;ESCO.0722.00297.0015;ESCO.0722.00297.0015i_02607;81079;81342;263
ESCO.0722.00297;ESCO.0722.00297.0015;ESCO.0722.00297.0015i_02639;101697;102890;1193
ESCO.0722.00297;ESCO.0722.00297.0018;ESCO.0722.00297.0018i_02767;84624;84845;221
ESCO.0722.00297;ESCO.0722.00297.0018;ESCO.0722.00297.0018i_02799;100713;101102;389
ESCO.0722.00297;ESCO.0722.00297.0019;ESCO.0722.00297.0019i_02927;103699;103932;233
ESCO.0722.00297;ESCO.0722.00297.0020;ESCO.0722.00297.0020i_03055;104093;106255;2162
ESCO.0722.00297;ESCO.0722.00297.0029;ESCO.0722.00297.0029i_03727;16744;17226;482
ESCO.0722.00297;ESCO.0722.00297.0029;ESCO.0722.00297.0029i_03759;36323;36619;296
ESCO.0722.00297;ESCO.0722.00297.0034;ESCO.0722.00297.0034b_03983;115;507;392
ESCO.0722.00297;ESCO.0722.00297.0072;ESCO.0722.00297.0072i_04943;4823;5212;389
ESCO.0722.00297;ESCO.0722.00297.0230;ESCO.0722.00297.0230b_05167;2;109;107
ESCO.0722.00297;ESCO.0722.00297.0003;ESCO.0722.00297.0003i_00848;233917;234351;434
ESCO.0722.00297;ESCO.0722.00297.0003;ESCO.0722.00297.0003b_00912;306718;307626;908
ESCO.0722.00297;ESCO.0722.00297.0015;ESCO.0722.00297.0015i_02608;81351;83477;2126
ESCO.0722.00297;ESCO.0722.00297.0018;ESCO.0722.00297.0018i_02768;84842;85369;527
ESCO.0722.00297;ESCO.0722.00297.0018;ESCO.0722.00297.0018i_02800;101296;102072;776
ESCO.0722.00297;ESCO.0722.00297.0029;ESCO.0722.00297.0029i_03728;17228;18394;1166
ESCO.0722.00297;ESCO.0722.00297.0029;ESCO.0722.00297.0029i_03760;36619;36807;188
ESCO.0722.00297;ESCO.0722.00297.0072;ESCO.0722.00297.0072i_04944;5280;5831;551
ESCO.0722.00297;ESCO.0722.00297.0093;ESCO.0722.00297.0093b_05040;3;2222;2219
ESCO.0722.00297;ESCO.0722.00297.0180;ESCO.0722.00297.0180b_05136;2;202;200
ESCO.0722.00297;ESCO.0722.00297.0232;ESCO.0722.00297.0232b_05168;1;108;107
ESCO.0722.00297;ESCO.0722.00297.0015;ESCO.0722.00297.0015i_02584;61012;63195;2183
ESCO.0722.00297;ESCO.0722.00297.0015;ESCO.0722.00297.0015i_02616;87441;88130;689
ESCO.0722.00297;ESCO.0722.00297.0018;ESCO.0722.00297.0018i_02776;89000;89434;434
ESCO.0722.00297;ESCO.0722.00297.0018;ESCO.0722.00297.0018i_02808;108926;109207;281
ESCO.0722.00297;ESCO.0722.00297.0020;ESCO.0722.00297.0020i_03032;81830;82231;401
ESCO.0722.00297;ESCO.0722.00297.0021;ESCO.0722.00297.0021i_03096;28955;30490;1535
ESCO.0722.00297;ESCO.0722.00297.0029;ESCO.0722.00297.0029b_03704;3;644;641
ESCO.0722.00297;ESCO.0722.00297.0029;ESCO.0722.00297.0029i_03736;24173;24412;239
ESCO.0722.00297;ESCO.0722.00297.0029;ESCO.0722.00297.0029i_03768;39141;39878;737
ESCO.0722.00297;ESCO.0722.00297.0067;ESCO.0722.00297.0067b_04888;12181;12474;293
ESCO.0722.00297;ESCO.0722.00297.0192;ESCO.0722.00297.0192b_05144;1;213;212
ESCO.0722.00297;ESCO.0722.00297.0002;ESCO.0722.00297.0002i_00611;297978;298466;488
ESCO.0722.00297;ESCO.0722.00297.0015;ESCO.0722.00297.0015i_02595;72799;73077;278
ESCO.0722.00297;ESCO.0722.00297.0015;ESCO.0722.00297.0015i_02627;92014;92922;908
ESCO.0722.00297;ESCO.0722.00297.0018;ESCO.0722.00297.0018i_02819;115720;116022;302
ESCO.0722.00297;ESCO.0722.00297.0029;ESCO.0722.00297.0029i_03715;9345;9821;476
ESCO.0722.00297;ESCO.0722.00297.0033;ESCO.0722.00297.0033b_03939;145;1203;1058
ESCO.0722.00297;ESCO.0722.00297.0038;ESCO.0722.00297.0038i_04163;3951;5636;1685
ESCO.0722.00297;ESCO.0722.00297.0058;ESCO.0722.00297.0058i_04739;11873;13150;1277
ESCO.0722.00297;ESCO.0722.00297.0062;ESCO.0722.00297.0062i_04803;1566;1856;290
ESCO.0722.00297;ESCO.0722.00297.0086;ESCO.0722.00297.0086b_05027;2612;3946;1334
ESCO.0722.00297;ESCO.0722.00297.0102;ESCO.0722.00297.0102b_05059;3;1418;1415
ESCO.0722.00297;ESCO.0722.00297.0002;ESCO.0722.00297.0002i_00612;298549;299676;1127
ESCO.0722.00297;ESCO.0722.00297.0014;ESCO.0722.00297.0014b_02372;109;1350;1241
ESCO.0722.00297;ESCO.0722.00297.0015;ESCO.0722.00297.0015i_02596;73079;73450;371
ESCO.0722.00297;ESCO.0722.00297.0018;ESCO.0722.00297.0018i_02788;94829;95608;779
ESCO.0722.00297;ESCO.0722.00297.0018;ESCO.0722.00297.0018i_02820;116025;117086;1061
ESCO.0722.00297;ESCO.0722.00297.0029;ESCO.0722.00297.0029i_03716;9893;10273;380
ESCO.0722.00297;ESCO.0722.00297.0038;ESCO.0722.00297.0038i_04164;5626;6783;1157
ESCO.0722.00297;ESCO.0722.00297.0043;ESCO.0722.00297.0043i_04260;5916;6287;371
ESCO.0722.00297;ESCO.0722.00297.0058;ESCO.0722.00297.0058i_04740;13153;14271;1118
ESCO.0722.00297;ESCO.0722.00297.0062;ESCO.0722.00297.0062i_04804;1885;2391;506
ESCO.0722.00297;ESCO.0722.00297.0162;ESCO.0722.00297.0162b_05124;3;284;281
ESCO.0722.00297;ESCO.0722.00297.0002;ESCO.0722.00297.0002i_00613;300084;300893;809
ESCO.0722.00297;ESCO.0722.00297.0015;ESCO.0722.00297.0015i_02597;73454;74965;1511
ESCO.0722.00297;ESCO.0722.00297.0015;ESCO.0722.00297.0015i_02629;93007;93564;557
ESCO.0722.00297;ESCO.0722.00297.0018;ESCO.0722.00297.0018i_02789;95601;95861;260
ESCO.0722.00297;ESCO.0722.00297.0018;ESCO.0722.00297.0018i_02821;117090;117428;338
ESCO.0722.00297;ESCO.0722.00297.0029;ESCO.0722.00297.0029i_03717;10349;10603;254
ESCO.0722.00297;ESCO.0722.00297.0038;ESCO.0722.00297.0038i_04165;6786;7634;848
ESCO.0722.00297;ESCO.0722.00297.0058;ESCO.0722.00297.0058i_04741;14307;15566;1259
ESCO.0722.00297;ESCO.0722.00297.0128;ESCO.0722.00297.0128b_05093;3;497;494
ESCO.0722.00297;ESCO.0722.00297.0002;ESCO.0722.00297.0002i_00608;294376;295608;1232
ESCO.0722.00297;ESCO.0722.00297.0008;ESCO.0722.00297.0008i_01728;105659;106690;1031
ESCO.0722.00297;ESCO.0722.00297.0010;ESCO.0722.00297.0010i_01888;78521;78943;422
ESCO.0722.00297;ESCO.0722.00297.0015;ESCO.0722.00297.0015i_02592;68275;69360;1085
ESCO.0722.00297;ESCO.0722.00297.0015;ESCO.0722.00297.0015i_02624;90750;90986;236
ESCO.0722.00297;ESCO.0722.00297.0018;ESCO.0722.00297.0018i_02784;93258;93521;263
ESCO.0722.00297;ESCO.0722.00297.0018;ESCO.0722.00297.0018i_02816;113086;113238;152
ESCO.0722.00297;ESCO.0722.00297.0029;ESCO.0722.00297.0029i_03712;6340;7179;839
ESCO.0722.00297;ESCO.0722.00297.0038;ESCO.0722.00297.0038b_04160;469;1734;1265
ESCO.0722.00297;ESCO.0722.00297.0053;ESCO.0722.00297.0053i_04576;736;2694;1958
ESCO.0722.00297;ESCO.0722.00297.0058;ESCO.0722.00297.0058i_04736;8549;9943;1394
ESCO.0722.00297;ESCO.0722.00297.0060;ESCO.0722.00297.0060i_04768;346;753;407
ESCO.0722.00297;ESCO.0722.00297.0200;ESCO.0722.00297.0200b_05152;3;98;95
ESCO.0722.00297;ESCO.0722.00297.0002;ESCO.0722.00297.0002i_00609;295881;296918;1037
ESCO.0722.00297;ESCO.0722.00297.0008;ESCO.0722.00297.0008i_01633;7737;8105;368
ESCO.0722.00297;ESCO.0722.00297.0015;ESCO.0722.00297.0015i_02593;69357;70757;1400
ESCO.0722.00297;ESCO.0722.00297.0018;ESCO.0722.00297.0018i_02785;93514;94020;506
ESCO.0722.00297;ESCO.0722.00297.0018;ESCO.0722.00297.0018i_02817;113228;115144;1916
ESCO.0722.00297;ESCO.0722.00297.0029;ESCO.0722.00297.0029i_03713;7183;8880;1697
ESCO.0722.00297;ESCO.0722.00297.0038;ESCO.0722.00297.0038i_04161;1935;3404;1469
ESCO.0722.00297;ESCO.0722.00297.0058;ESCO.0722.00297.0058i_04737;10003;11202;1199
ESCO.0722.00297;ESCO.0722.00297.0086;ESCO.0722.00297.0086b_05025;3;542;539
ESCO.0722.00297;ESCO.0722.00297.0101;ESCO.0722.00297.0101b_05057;3;113;110
ESCO.0722.00297;ESCO.0722.00297.0002;ESCO.0722.00297.0002i_00610;296937;297893;956
ESCO.0722.00297;ESCO.0722.00297.0009;ESCO.0722.00297.0009b_01730;28;162;134
ESCO.0722.00297;ESCO.0722.00297.0015;ESCO.0722.00297.0015i_02594;70804;72657;1853
ESCO.0722.00297;ESCO.0722.00297.0018;ESCO.0722.00297.0018i_02786;94021;94368;347
ESCO.0722.00297;ESCO.0722.00297.0018;ESCO.0722.00297.0018i_02818;115144;115719;575
ESCO.0722.00297;ESCO.0722.00297.0021;ESCO.0722.00297.0021i_03106;41887;42432;545
ESCO.0722.00297;ESCO.0722.00297.0029;ESCO.0722.00297.0029i_03714;8913;9140;227
ESCO.0722.00297;ESCO.0722.00297.0038;ESCO.0722.00297.0038i_04162;3401;3943;542
ESCO.0722.00297;ESCO.0722.00297.0058;ESCO.0722.00297.0058i_04738;11189;11863;674
ESCO.0722.00297;ESCO.0722.00297.0062;ESCO.0722.00297.0062i_04802;1235;1546;311
ESCO.0722.00297;ESCO.0722.00297.0086;ESCO.0722.00297.0086i_05026;867;2609;1742
ESCO.0722.00297;ESCO.0722.00297.0204;ESCO.0722.00297.0204b_05154;27;158;131
ESCO.0722.00297;ESCO.0722.00297.0003;ESCO.0722.00297.0003i_00715;96603;98105;1502
ESCO.0722.00297;ESCO.0722.00297.0003;ESCO.0722.00297.0003i_00907;303267;303644;377
ESCO.0722.00297;ESCO.0722.00297.0015;ESCO.0722.00297.0015i_02603;77583;77990;407
ESCO.0722.00297;ESCO.0722.00297.0015;ESCO.0722.00297.0015i_02635;96526;96687;161
ESCO.0722.00297;ESCO.0722.00297.0018;ESCO.0722.00297.0018i_02763;83333;83578;245
ESCO.0722.00297;ESCO.0722.00297.0018;ESCO.0722.00297.0018i_02795;97990;98130;140
ESCO.0722.00297;ESCO.0722.00297.0018;ESCO.0722.00297.0018i_02827;120914;121795;881
ESCO.0722.00297;ESCO.0722.00297.0021;ESCO.0722.00297.0021i_03083;14934;15083;149
ESCO.0722.00297;ESCO.0722.00297.0024;ESCO.0722.00297.0024i_03403;66258;66719;461
ESCO.0722.00297;ESCO.0722.00297.0029;ESCO.0722.00297.0029i_03723;14370;14933;563
ESCO.0722.00297;ESCO.0722.00297.0029;ESCO.0722.00297.0029i_03755;33847;34113;266
ESCO.0722.00297;ESCO.0722.00297.0043;ESCO.0722.00297.0043i_04267;14912;15040;128
ESCO.0722.00297;ESCO.0722.00297.0002;ESCO.0722.00297.0002i_00364;48207;48401;194
ESCO.0722.00297;ESCO.0722.00297.0015;ESCO.0722.00297.0015i_02604;77990;78580;590
ESCO.0722.00297;ESCO.0722.00297.0015;ESCO.0722.00297.0015i_02636;96826;100056;3230
ESCO.0722.00297;ESCO.0722.00297.0018;ESCO.0722.00297.0018i_02764;83600;83734;134
ESCO.0722.00297;ESCO.0722.00297.0018;ESCO.0722.00297.0018i_02796;98127;98816;689
ESCO.0722.00297;ESCO.0722.00297.0018;ESCO.0722.00297.0018i_02828;121795;121965;170
ESCO.0722.00297;ESCO.0722.00297.0024;ESCO.0722.00297.0024i_03404;66722;67522;800
ESCO.0722.00297;ESCO.0722.00297.0029;ESCO.0722.00297.0029i_03724;14936;15379;443
ESCO.0722.00297;ESCO.0722.00297.0029;ESCO.0722.00297.0029i_03756;34281;34751;470
ESCO.0722.00297;ESCO.0722.00297.0015;ESCO.0722.00297.0015i_02605;78582;79448;866
ESCO.0722.00297;ESCO.0722.00297.0015;ESCO.0722.00297.0015i_02637;100065;101180;1115
ESCO.0722.00297;ESCO.0722.00297.0018;ESCO.0722.00297.0018i_02765;83738;83956;218
ESCO.0722.00297;ESCO.0722.00297.0018;ESCO.0722.00297.0018i_02797;99896;100210;314
ESCO.0722.00297;ESCO.0722.00297.0018;ESCO.0722.00297.0018b_02829;122047;122451;404
ESCO.0722.00297;ESCO.0722.00297.0022;ESCO.0722.00297.0022i_03181;15449;17413;1964
ESCO.0722.00297;ESCO.0722.00297.0023;ESCO.0722.00297.0023i_03309;61086;61247;161
ESCO.0722.00297;ESCO.0722.00297.0029;ESCO.0722.00297.0029i_03725;15379;15705;326
ESCO.0722.00297;ESCO.0722.00297.0029;ESCO.0722.00297.0029i_03757;35217;35600;383
ESCO.0722.00297;ESCO.0722.00297.0015;ESCO.0722.00297.0015i_02582;60042;60236;194
ESCO.0722.00297;ESCO.0722.00297.0018;ESCO.0722.00297.0018i_02774;88319;88429;110
ESCO.0722.00297;ESCO.0722.00297.0018;ESCO.0722.00297.0018i_02806;107439;107933;494
ESCO.0722.00297;ESCO.0722.00297.0029;ESCO.0722.00297.0029i_03734;23711;23938;227
ESCO.0722.00297;ESCO.0722.00297.0069;ESCO.0722.00297.0069i_04918;10356;10802;446
ESCO.0722.00297;ESCO.0722.00297.0146;ESCO.0722.00297.0146b_05110;1;375;374
ESCO.0722.00297;ESCO.0722.00297.0002;ESCO.0722.00297.0002i_00602;288314;288658;344
ESCO.0722.00297;ESCO.0722.00297.0006;ESCO.0722.00297.0006i_01210;22290;22448;158
ESCO.0722.00297;ESCO.0722.00297.0008;ESCO.0722.00297.0008i_01626;3481;5256;1775
ESCO.0722.00297;ESCO.0722.00297.0011;ESCO.0722.00297.0011i_02074;104652;104933;281
ESCO.0722.00297;ESCO.0722.00297.0015;ESCO.0722.00297.0015i_02586;63560;64651;1091
ESCO.0722.00297;ESCO.0722.00297.0018;ESCO.0722.00297.0018i_02778;90252;90473;221
ESCO.0722.00297;ESCO.0722.00297.0018;ESCO.0722.00297.0018i_02810;109592;110098;506
ESCO.0722.00297;ESCO.0722.00297.0029;ESCO.0722.00297.0029i_03706;1956;2543;587
ESCO.0722.00297;ESCO.0722.00297.0029;ESCO.0722.00297.0029i_03770;40374;40937;563
ESCO.0722.00297;ESCO.0722.00297.0054;ESCO.0722.00297.0054i_04634;24691;25071;380
ESCO.0722.00297;ESCO.0722.00297.0055;ESCO.0722.00297.0055b_04666;25531;27591;2060
ESCO.0722.00297;ESCO.0722.00297.0149;ESCO.0722.00297.0149b_05114;3;341;338
ESCO.0722.00297;ESCO.0722.00297.0194;ESCO.0722.00297.0194b_05146;3;209;206
ESCO.0722.00297;ESCO.0722.00297.0255;ESCO.0722.00297.0255b_05178;2;67;65
ESCO.0722.00297;ESCO.0722.00297.0002;ESCO.0722.00297.0002i_00603;288681;289520;839
ESCO.0722.00297;ESCO.0722.00297.0006;ESCO.0722.00297.0006i_01211;22843;23394;551
ESCO.0722.00297;ESCO.0722.00297.0015;ESCO.0722.00297.0015i_02587;64630;65415;785
ESCO.0722.00297;ESCO.0722.00297.0018;ESCO.0722.00297.0018i_02779;90513;90734;221
ESCO.0722.00297;ESCO.0722.00297.0018;ESCO.0722.00297.0018i_02811;110098;110484;386
ESCO.0722.00297;ESCO.0722.00297.0023;ESCO.0722.00297.0023b_03259;33;296;263
ESCO.0722.00297;ESCO.0722.00297.0029;ESCO.0722.00297.0029i_03707;2536;3768;1232
ESCO.0722.00297;ESCO.0722.00297.0150;ESCO.0722.00297.0150b_05115;3;113;110
ESCO.0722.00297;ESCO.0722.00297.0195;ESCO.0722.00297.0195b_05147;2;208;206
ESCO.0722.00297;ESCO.0722.00297.0002;ESCO.0722.00297.0002i_00604;289613;290410;797
ESCO.0722.00297;ESCO.0722.00297.0004;ESCO.0722.00297.0004i_00988;76974;77171;197
ESCO.0722.00297;ESCO.0722.00297.0006;ESCO.0722.00297.0006i_01212;26023;26199;176
ESCO.0722.00297;ESCO.0722.00297.0006;ESCO.0722.00297.0006i_01244;49602;49973;371
ESCO.0722.00297;ESCO.0722.00297.0015;ESCO.0722.00297.0015i_02588;65442;66116;674
ESCO.0722.00297;ESCO.0722.00297.0015;ESCO.0722.00297.0015i_02620;88913;89119;206
ESCO.0722.00297;ESCO.0722.00297.0018;ESCO.0722.00297.0018i_02780;90820;91674;854
ESCO.0722.00297;ESCO.0722.00297.0018;ESCO.0722.00297.0018i_02812;110477;111019;542
ESCO.0722.00297;ESCO.0722.00297.0029;ESCO.0722.00297.0029i_03708;3776;4132;356
ESCO.0722.00297;ESCO.0722.00297.0029;ESCO.0722.00297.0029i_03772;41577;42200;623
ESCO.0722.00297;ESCO.0722.00297.0068;ESCO.0722.00297.0068i_04892;3306;4850;1544
ESCO.0722.00297;ESCO.0722.00297.0098;ESCO.0722.00297.0098b_05052;608;2089;1481
ESCO.0722.00297;ESCO.0722.00297.0196;ESCO.0722.00297.0196b_05148;3;206;203
ESCO.0722.00297;ESCO.0722.00297.0002;ESCO.0722.00297.0002i_00605;290432;292231;1799
ESCO.0722.00297;ESCO.0722.00297.0006;ESCO.0722.00297.0006i_01213;26222;26392;170
ESCO.0722.00297;ESCO.0722.00297.0012;ESCO.0722.00297.0012b_02205;45382;45552;170
ESCO.0722.00297;ESCO.0722.00297.0015;ESCO.0722.00297.0015i_02589;66113;67261;1148
ESCO.0722.00297;ESCO.0722.00297.0015;ESCO.0722.00297.0015i_02621;89119;89718;599
ESCO.0722.00297;ESCO.0722.00297.0018;ESCO.0722.00297.0018i_02781;91677;92528;851
ESCO.0722.00297;ESCO.0722.00297.0018;ESCO.0722.00297.0018i_02813;111023;112168;1145
ESCO.0722.00297;ESCO.0722.00297.0029;ESCO.0722.00297.0029i_03709;4587;5177;590
ESCO.0722.00297;ESCO.0722.00297.0043;ESCO.0722.00297.0043b_04285;35798;35959;161
ESCO.0722.00297;ESCO.0722.00297.0058;ESCO.0722.00297.0058i_04733;4883;5317;434
ESCO.0722.00297;ESCO.0722.00297.0099;ESCO.0722.00297.0099b_05053;3;2081;2078
ESCO.0722.00297;ESCO.0722.00297.0120;ESCO.0722.00297.0120b_05085;30;743;713
ESCO.0722.00297;ESCO.0722.00297.0002;ESCO.0722.00297.0002i_00486;172801;173067;266
ESCO.0722.00297;ESCO.0722.00297.0002;ESCO.0722.00297.0002i_00614;300981;302849;1868
ESCO.0722.00297;ESCO.0722.00297.0015;ESCO.0722.00297.0015i_02630;93576;93794;218
ESCO.0722.00297;ESCO.0722.00297.0018;ESCO.0722.00297.0018i_02790;95861;96091;230
ESCO.0722.00297;ESCO.0722.00297.0018;ESCO.0722.00297.0018i_02822;117431;117877;446
ESCO.0722.00297;ESCO.0722.00297.0029;ESCO.0722.00297.0029i_03718;10606;11361;755
ESCO.0722.00297;ESCO.0722.00297.0038;ESCO.0722.00297.0038i_04166;7645;11931;4286
ESCO.0722.00297;ESCO.0722.00297.0058;ESCO.0722.00297.0058i_04742;15627;16904;1277
ESCO.0722.00297;ESCO.0722.00297.0165;ESCO.0722.00297.0165b_05126;2;280;278
ESCO.0722.00297;ESCO.0722.00297.0002;ESCO.0722.00297.0002i_00487;173068;173376;308
ESCO.0722.00297;ESCO.0722.00297.0002;ESCO.0722.00297.0002i_00615;302886;305960;3074
ESCO.0722.00297;ESCO.0722.00297.0008;ESCO.0722.00297.0008i_01639;13824;14450;626
ESCO.0722.00297;ESCO.0722.00297.0015;ESCO.0722.00297.0015i_02599;75150;75695;545
ESCO.0722.00297;ESCO.0722.00297.0015;ESCO.0722.00297.0015i_02631;93899;94285;386
ESCO.0722.00297;ESCO.0722.00297.0018;ESCO.0722.00297.0018i_02823;117940;118593;653
ESCO.0722.00297;ESCO.0722.00297.0029;ESCO.0722.00297.0029i_03719;11544;11987;443
ESCO.0722.00297;ESCO.0722.00297.0038;ESCO.0722.00297.0038i_04167;11928;13214;1286
ESCO.0722.00297;ESCO.0722.00297.0130;ESCO.0722.00297.0130b_05095;2;484;482
ESCO.0722.00297;ESCO.0722.00297.0166;ESCO.0722.00297.0166b_05127;2;280;278
ESCO.0722.00297;ESCO.0722.00297.0007;ESCO.0722.00297.0007b_01620;183237;184433;1196
ESCO.0722.00297;ESCO.0722.00297.0008;ESCO.0722.00297.0008i_01652;22515;23489;974
ESCO.0722.00297;ESCO.0722.00297.0015;ESCO.0722.00297.0015i_02580;59028;59576;548
ESCO.0722.00297;ESCO.0722.00297.0018;ESCO.0722.00297.0018i_02772;87073;88044;971
ESCO.0722.00297;ESCO.0722.00297.0018;ESCO.0722.00297.0018i_02804;105755;106177;422
ESCO.0722.00297;ESCO.0722.00297.0019;ESCO.0722.00297.0019i_02868;43248;44231;983
ESCO.0722.00297;ESCO.0722.00297.0020;ESCO.0722.00297.0020i_03060;108828;109691;863
ESCO.0722.00297;ESCO.0722.00297.0021;ESCO.0722.00297.0021i_03092;22470;26459;3989
ESCO.0722.00297;ESCO.0722.00297.0027;ESCO.0722.00297.0027b_03636;76078;76716;638
ESCO.0722.00297;ESCO.0722.00297.0029;ESCO.0722.00297.0029i_03732;22348;22833;485
ESCO.0722.00297;ESCO.0722.00297.0031;ESCO.0722.00297.0031i_03892;46413;46532;119
ESCO.0722.00297;ESCO.0722.00297.0061;ESCO.0722.00297.0061i_04788;9605;9892;287
ESCO.0722.00297;ESCO.0722.00297.0095;ESCO.0722.00297.0095b_05044;3;2264;2261
ESCO.0722.00297;ESCO.0722.00297.0188;ESCO.0722.00297.0188b_05140;1;222;221
ESCO.0722.00297;ESCO.0722.00297.0015;ESCO.0722.00297.0015i_02613;85960;86430;470
ESCO.0722.00297;ESCO.0722.00297.0018;ESCO.0722.00297.0018i_02773;88132;88326;194
ESCO.0722.00297;ESCO.0722.00297.0018;ESCO.0722.00297.0018i_02805;106233;107435;1202
ESCO.0722.00297;ESCO.0722.00297.0019;ESCO.0722.00297.0019i_02869;44292;46529;2237
ESCO.0722.00297;ESCO.0722.00297.0028;ESCO.0722.00297.0028b_03637;1;666;665
ESCO.0722.00297;ESCO.0722.00297.0031;ESCO.0722.00297.0031i_03893;46915;48111;1196
ESCO.0722.00297;ESCO.0722.00297.0189;ESCO.0722.00297.0189b_05141;1;81;80
ESCO.0722.00297;ESCO.0722.00297.0242;ESCO.0722.00297.0242b_05173;1;87;86
ESCO.0722.00306;ESCO.0722.00306.0004;ESCO.0722.00306.0004i_00639;69009;69914;905
ESCO.0722.00306;ESCO.0722.00306.0043;ESCO.0722.00306.0043i_03935;40187;40360;173
ESCO.0722.00306;ESCO.0722.00306.0048;ESCO.0722.00306.0048i_04063;4069;4587;518
ESCO.0722.00306;ESCO.0722.00306.0048;ESCO.0722.00306.0048i_04095;29936;30475;539
ESCO.0722.00306;ESCO.0722.00306.0193;ESCO.0722.00306.0193b_04863;1;249;248
ESCO.0722.00306;ESCO.0722.00306.0235;ESCO.0722.00306.0235b_04895;1;111;110
ESCO.0722.00306;ESCO.0722.00306.0003;ESCO.0722.00306.0003b_00302;447;878;431
ESCO.0722.00306;ESCO.0722.00306.0048;ESCO.0722.00306.0048i_04078;13125;13631;506
ESCO.0722.00306;ESCO.0722.00306.0252;ESCO.0722.00306.0252b_04910;3;206;203
ESCO.0722.00306;ESCO.0722.00306.0024;ESCO.0722.00306.0024i_02927;35397;35579;182
ESCO.0722.00306;ESCO.0722.00306.0033;ESCO.0722.00306.0033b_03503;2;178;176
ESCO.0722.00306;ESCO.0722.00306.0044;ESCO.0722.00306.0044i_03951;11734;13419;1685
ESCO.0722.00306;ESCO.0722.00306.0048;ESCO.0722.00306.0048i_04079;13896;16040;2144
ESCO.0722.00306;ESCO.0722.00306.0140;ESCO.0722.00306.0140b_04815;3;518;515
ESCO.0722.00306;ESCO.0722.00306.0213;ESCO.0722.00306.0213b_04879;1;234;233
ESCO.0722.00306;ESCO.0722.00306.0253;ESCO.0722.00306.0253b_04911;143;208;65
ESCO.0722.00306;ESCO.0722.00306.0024;ESCO.0722.00306.0024i_02928;35652;36035;383
ESCO.0722.00306;ESCO.0722.00306.0048;ESCO.0722.00306.0048i_04080;16139;16717;578
ESCO.0722.00306;ESCO.0722.00306.0091;ESCO.0722.00306.0091i_04720;1611;2474;863
ESCO.0722.00306;ESCO.0722.00306.0141;ESCO.0722.00306.0141b_04816;2;496;494
ESCO.0722.00306;ESCO.0722.00306.0214;ESCO.0722.00306.0214b_04880;2;232;230
ESCO.0722.00306;ESCO.0722.00306.0254;ESCO.0722.00306.0254b_04912;2;205;203
ESCO.0722.00306;ESCO.0722.00306.0008;ESCO.0722.00306.0008i_01092;58270;58896;626
ESCO.0722.00306;ESCO.0722.00306.0034;ESCO.0722.00306.0034i_03524;14652;15218;566
ESCO.0722.00306;ESCO.0722.00306.0048;ESCO.0722.00306.0048i_04068;6490;6924;434
ESCO.0722.00306;ESCO.0722.00306.0048;ESCO.0722.00306.0048i_04100;31788;32030;242
ESCO.0722.00306;ESCO.0722.00306.0098;ESCO.0722.00306.0098b_04740;32;889;857
ESCO.0722.00306;ESCO.0722.00306.0131;ESCO.0722.00306.0131b_04804;3;269;266
ESCO.0722.00306;ESCO.0722.00306.0240;ESCO.0722.00306.0240b_04900;8;214;206
ESCO.0722.00306;ESCO.0722.00306.0008;ESCO.0722.00306.0008i_01093;58911;61670;2759
ESCO.0722.00306;ESCO.0722.00306.0034;ESCO.0722.00306.0034i_03525;15232;15414;182
ESCO.0722.00306;ESCO.0722.00306.0048;ESCO.0722.00306.0048i_04069;7051;7566;515
ESCO.0722.00306;ESCO.0722.00306.0048;ESCO.0722.00306.0048i_04101;32027;32452;425
ESCO.0722.00306;ESCO.0722.00306.0200;ESCO.0722.00306.0200b_04869;1;240;239
ESCO.0722.00306;ESCO.0722.00306.0241;ESCO.0722.00306.0241b_04901;1;108;107
ESCO.0722.00306;ESCO.0722.00306.0289;ESCO.0722.00306.0289b_04933;3;92;89
ESCO.0722.00306;ESCO.0722.00306.0048;ESCO.0722.00306.0048i_04061;3364;3636;272
ESCO.0722.00306;ESCO.0722.00306.0048;ESCO.0722.00306.0048i_04093;29155;29601;446
ESCO.0722.00306;ESCO.0722.00306.0232;ESCO.0722.00306.0232b_04893;1;69;68
ESCO.0722.00306;ESCO.0722.00306.0048;ESCO.0722.00306.0048i_04055;587;970;383
ESCO.0722.00306;ESCO.0722.00306.0048;ESCO.0722.00306.0048i_04087;24129;24422;293
ESCO.0722.00306;ESCO.0722.00306.0124;ESCO.0722.00306.0124b_04791;3;170;167
ESCO.0722.00306;ESCO.0722.00306.0221;ESCO.0722.00306.0221b_04887;2;166;164
ESCO.0722.00306;ESCO.0722.00306.0022;ESCO.0722.00306.0022i_02776;88610;89911;1301
ESCO.0722.00306;ESCO.0722.00306.0043;ESCO.0722.00306.0043i_03928;33529;33828;299
ESCO.0722.00306;ESCO.0722.00306.0048;ESCO.0722.00306.0048i_04056;970;1446;476
ESCO.0722.00306;ESCO.0722.00306.0048;ESCO.0722.00306.0048i_04088;24485;25051;566
ESCO.0722.00306;ESCO.0722.00306.0222;ESCO.0722.00306.0222b_04888;118;225;107
ESCO.0722.00306;ESCO.0722.00306.0048;ESCO.0722.00306.0048i_04057;1452;1640;188
ESCO.0722.00306;ESCO.0722.00306.0048;ESCO.0722.00306.0048i_04089;25154;27370;2216
ESCO.0722.00306;ESCO.0722.00306.0034;ESCO.0722.00306.0034i_03540;24378;25133;755
ESCO.0722.00306;ESCO.0722.00306.0036;ESCO.0722.00306.0036b_03668;53000;53446;446
ESCO.0722.00306;ESCO.0722.00306.0048;ESCO.0722.00306.0048i_04084;20127;22025;1898
ESCO.0722.00306;ESCO.0722.00306.0048;ESCO.0722.00306.0048i_04085;22047;22694;647
ESCO.0722.00306;ESCO.0722.00306.0053;ESCO.0722.00306.0053i_04245;18416;19438;1022
ESCO.0722.00306;ESCO.0722.00306.0122;ESCO.0722.00306.0122b_04789;3;896;893
ESCO.0722.00306;ESCO.0722.00306.0261;ESCO.0722.00306.0261b_04917;3;182;179
ESCO.0722.00306;ESCO.0722.00306.0048;ESCO.0722.00306.0048b_04054;1;561;560
ESCO.0722.00306;ESCO.0722.00306.0048;ESCO.0722.00306.0048i_04086;22840;24015;1175
ESCO.0722.00306;ESCO.0722.00306.0179;ESCO.0722.00306.0179b_04854;2;286;284
ESCO.0722.00306;ESCO.0722.00306.0220;ESCO.0722.00306.0220b_04886;2;226;224
ESCO.0722.00306;ESCO.0722.00306.0008;ESCO.0722.00306.0008i_01086;55674;56108;434
ESCO.0722.00306;ESCO.0722.00306.0029;ESCO.0722.00306.0029i_03326;43191;43637;446
ESCO.0722.00306;ESCO.0722.00306.0048;ESCO.0722.00306.0048i_04062;3641;3931;290
ESCO.0722.00306;ESCO.0722.00306.0048;ESCO.0722.00306.0048i_04094;29674;29919;245
ESCO.0722.00306;ESCO.0722.00306.0059;ESCO.0722.00306.0059i_04414;18341;18847;506
ESCO.0722.00306;ESCO.0722.00306.0107;ESCO.0722.00306.0107b_04766;1;1263;1262
ESCO.0722.00306;ESCO.0722.00306.0234;ESCO.0722.00306.0234b_04894;1;201;200
ESCO.0722.00306;ESCO.0722.00306.0008;ESCO.0722.00306.0008i_01097;64018;64236;218
ESCO.0722.00306;ESCO.0722.00306.0048;ESCO.0722.00306.0048i_04073;9732;10427;695
ESCO.0722.00306;ESCO.0722.00306.0048;ESCO.0722.00306.0048i_04105;33851;34507;656
ESCO.0722.00306;ESCO.0722.00306.0070;ESCO.0722.00306.0070i_04585;7724;8254;530
ESCO.0722.00306;ESCO.0722.00306.0206;ESCO.0722.00306.0206b_04873;70;237;167
ESCO.0722.00306;ESCO.0722.00306.0247;ESCO.0722.00306.0247b_04905;2;79;77
ESCO.0722.00306;ESCO.0722.00306.0048;ESCO.0722.00306.0048i_04074;10429;10836;407
ESCO.0722.00306;ESCO.0722.00306.0048;ESCO.0722.00306.0048i_04106;34676;34951;275
ESCO.0722.00306;ESCO.0722.00306.0135;ESCO.0722.00306.0135b_04810;353;574;221
ESCO.0722.00306;ESCO.0722.00306.0039;ESCO.0722.00306.0039b_03787;43623;44483;860
ESCO.0722.00306;ESCO.0722.00306.0048;ESCO.0722.00306.0048i_04075;10865;11776;911
ESCO.0722.00306;ESCO.0722.00306.0209;ESCO.0722.00306.0209b_04875;2;235;233
ESCO.0722.00306;ESCO.0722.00306.0249;ESCO.0722.00306.0249b_04907;3;209;206
ESCO.0722.00306;ESCO.0722.00306.0008;ESCO.0722.00306.0008i_01094;62059;62520;461
ESCO.0722.00306;ESCO.0722.00306.0048;ESCO.0722.00306.0048i_04070;7709;7966;257
ESCO.0722.00306;ESCO.0722.00306.0048;ESCO.0722.00306.0048i_04102;32442;32771;329
ESCO.0722.00306;ESCO.0722.00306.0059;ESCO.0722.00306.0059b_04390;30;956;926
ESCO.0722.00306;ESCO.0722.00306.0062;ESCO.0722.00306.0062b_04454;18;251;233
ESCO.0722.00306;ESCO.0722.00306.0068;ESCO.0722.00306.0068b_04550;311;481;170
ESCO.0722.00306;ESCO.0722.00306.0202;ESCO.0722.00306.0202b_04870;2;157;155
ESCO.0722.00306;ESCO.0722.00306.0243;ESCO.0722.00306.0243b_04902;1;213;212
ESCO.0722.00306;ESCO.0722.00306.0292;ESCO.0722.00306.0292b_04934;3;92;89
ESCO.0722.00306;ESCO.0722.00306.0048;ESCO.0722.00306.0048i_04071;7978;9213;1235
ESCO.0722.00306;ESCO.0722.00306.0048;ESCO.0722.00306.0048i_04103;32771;32980;209
ESCO.0722.00306;ESCO.0722.00306.0052;ESCO.0722.00306.0052i_04199;1668;1964;296
ESCO.0722.00306;ESCO.0722.00306.0062;ESCO.0722.00306.0062i_04455;719;982;263
ESCO.0722.00306;ESCO.0722.00306.0068;ESCO.0722.00306.0068i_04551;740;1135;395
ESCO.0722.00306;ESCO.0722.00306.0076;ESCO.0722.00306.0076i_04647;6829;7479;650
ESCO.0722.00306;ESCO.0722.00306.0088;ESCO.0722.00306.0088b_04711;2964;4256;1292
ESCO.0722.00306;ESCO.0722.00306.0203;ESCO.0722.00306.0203b_04871;2;214;212
ESCO.0722.00306;ESCO.0722.00306.0244;ESCO.0722.00306.0244b_04903;3;176;173
ESCO.0722.00306;ESCO.0722.00306.0008;ESCO.0722.00306.0008i_01096;63248;63625;377
ESCO.0722.00306;ESCO.0722.00306.0048;ESCO.0722.00306.0048i_04072;9321;9728;407
ESCO.0722.00306;ESCO.0722.00306.0048;ESCO.0722.00306.0048i_04104;32991;33518;527
ESCO.0722.00306;ESCO.0722.00306.0052;ESCO.0722.00306.0052i_04200;1882;2127;245
ESCO.0722.00306;ESCO.0722.00306.0076;ESCO.0722.00306.0076i_04648;7498;7974;476
ESCO.0722.00306;ESCO.0722.00306.0089;ESCO.0722.00306.0089b_04712;494;847;353
ESCO.0722.00306;ESCO.0722.00306.0113;ESCO.0722.00306.0113b_04776;666;923;257
ESCO.0722.00306;ESCO.0722.00306.0245;ESCO.0722.00306.0245b_04904;89;211;122
ESCO.0722.00306;ESCO.0722.00306.0048;ESCO.0722.00306.0048i_04081;16780;18786;2006
ESCO.0722.00306;ESCO.0722.00306.0091;ESCO.0722.00306.0091i_04721;2487;2849;362
ESCO.0722.00306;ESCO.0722.00306.0174;ESCO.0722.00306.0174b_04849;2;313;311
ESCO.0722.00306;ESCO.0722.00306.0215;ESCO.0722.00306.0215b_04881;1;231;230
ESCO.0722.00306;ESCO.0722.00306.0255;ESCO.0722.00306.0255b_04913;1;147;146
ESCO.0722.00306;ESCO.0722.00306.0026;ESCO.0722.00306.0026i_03090;17927;18283;356
ESCO.0722.00306;ESCO.0722.00306.0048;ESCO.0722.00306.0048i_04082;18904;19269;365
ESCO.0722.00306;ESCO.0722.00306.0071;ESCO.0722.00306.0071i_04594;4038;4856;818
ESCO.0722.00306;ESCO.0722.00306.0091;ESCO.0722.00306.0091b_04722;2868;3404;536
ESCO.0722.00306;ESCO.0722.00306.0101;ESCO.0722.00306.0101b_04754;1121;1936;815
ESCO.0722.00306;ESCO.0722.00306.0216;ESCO.0722.00306.0216b_04882;3;185;182
ESCO.0722.00306;ESCO.0722.00306.0257;ESCO.0722.00306.0257b_04914;2;205;203
ESCO.0722.00306;ESCO.0722.00306.0026;ESCO.0722.00306.0026i_03091;18451;18699;248
ESCO.0722.00306;ESCO.0722.00306.0034;ESCO.0722.00306.0034i_03539;23905;24372;467
ESCO.0722.00306;ESCO.0722.00306.0048;ESCO.0722.00306.0048i_04083;19349;19975;626
ESCO.0722.00306;ESCO.0722.00306.0071;ESCO.0722.00306.0071i_04595;4860;5108;248
ESCO.0722.00306;ESCO.0722.00306.0092;ESCO.0722.00306.0092b_04723;1;357;356
ESCO.0722.00306;ESCO.0722.00306.0217;ESCO.0722.00306.0217b_04883;2;229;227
ESCO.0722.00306;ESCO.0722.00306.0008;ESCO.0722.00306.0008i_01084;54421;55344;923
ESCO.0722.00306;ESCO.0722.00306.0048;ESCO.0722.00306.0048i_04060;2555;3250;695
ESCO.0722.00306;ESCO.0722.00306.0048;ESCO.0722.00306.0048i_04092;28579;29067;488
ESCO.0722.00306;ESCO.0722.00306.0086;ESCO.0722.00306.0086i_04700;591;830;239
ESCO.0722.00306;ESCO.0722.00306.0230;ESCO.0722.00306.0230b_04892;3;221;218
ESCO.0722.00306;ESCO.0722.00306.0008;ESCO.0722.00306.0008i_01088;56947;57129;182
ESCO.0722.00306;ESCO.0722.00306.0009;ESCO.0722.00306.0009b_01376;195539;195640;101
ESCO.0722.00306;ESCO.0722.00306.0048;ESCO.0722.00306.0048i_04064;4598;4918;320
ESCO.0722.00306;ESCO.0722.00306.0048;ESCO.0722.00306.0048i_04096;30491;31048;557
ESCO.0722.00306;ESCO.0722.00306.0194;ESCO.0722.00306.0194b_04864;2;247;245
ESCO.0722.00306;ESCO.0722.00306.0236;ESCO.0722.00306.0236b_04896;130;219;89
ESCO.0722.00306;ESCO.0722.00306.0008;ESCO.0722.00306.0008i_01089;57116;57841;725
ESCO.0722.00306;ESCO.0722.00306.0022;ESCO.0722.00306.0022i_02785;98115;98411;296
ESCO.0722.00306;ESCO.0722.00306.0043;ESCO.0722.00306.0043b_03937;40871;41269;398
ESCO.0722.00306;ESCO.0722.00306.0048;ESCO.0722.00306.0048i_04065;5346;5663;317
ESCO.0722.00306;ESCO.0722.00306.0048;ESCO.0722.00306.0048i_04097;31051;31362;311
ESCO.0722.00306;ESCO.0722.00306.0195;ESCO.0722.00306.0195b_04865;2;247;245
ESCO.0722.00306;ESCO.0722.00306.0237;ESCO.0722.00306.0237b_04897;2;217;215
ESCO.0722.00306;ESCO.0722.00306.0003;ESCO.0722.00306.0003i_00578;292689;292898;209
ESCO.0722.00306;ESCO.0722.00306.0008;ESCO.0722.00306.0008i_01090;57834;58013;179
ESCO.0722.00306;ESCO.0722.00306.0034;ESCO.0722.00306.0034i_03522;12267;14171;1904
ESCO.0722.00306;ESCO.0722.00306.0048;ESCO.0722.00306.0048i_04066;5663;6025;362
ESCO.0722.00306;ESCO.0722.00306.0048;ESCO.0722.00306.0048i_04098;31364;31486;122
ESCO.0722.00306;ESCO.0722.00306.0097;ESCO.0722.00306.0097i_04738;1090;1632;542
ESCO.0722.00306;ESCO.0722.00306.0238;ESCO.0722.00306.0238b_04898;1;216;215
ESCO.0722.00306;ESCO.0722.00306.0008;ESCO.0722.00306.0008i_01091;58010;58273;263
ESCO.0722.00306;ESCO.0722.00306.0034;ESCO.0722.00306.0034i_03523;14158;14658;500
ESCO.0722.00306;ESCO.0722.00306.0048;ESCO.0722.00306.0048i_04067;6106;6477;371
ESCO.0722.00306;ESCO.0722.00306.0048;ESCO.0722.00306.0048i_04099;31498;31791;293
ESCO.0722.00306;ESCO.0722.00306.0097;ESCO.0722.00306.0097b_04739;1824;2009;185
ESCO.0722.00306;ESCO.0722.00306.0239;ESCO.0722.00306.0239b_04899;3;215;212
ESCO.0722.00306;ESCO.0722.00306.0048;ESCO.0722.00306.0048i_04076;12168;12590;422
ESCO.0722.00306;ESCO.0722.00306.0210;ESCO.0722.00306.0210b_04876;2;235;233
ESCO.0722.00306;ESCO.0722.00306.0250;ESCO.0722.00306.0250b_04908;3;209;206
ESCO.0722.00306;ESCO.0722.00306.0310;ESCO.0722.00306.0310b_04940;2;67;65
ESCO.0722.00306;ESCO.0722.00306.0020;ESCO.0722.00306.0020b_02573;114983;116869;1886
ESCO.0722.00306;ESCO.0722.00306.0044;ESCO.0722.00306.0044i_03949;10508;10753;245
ESCO.0722.00306;ESCO.0722.00306.0048;ESCO.0722.00306.0048i_04077;12593;13006;413
ESCO.0722.00306;ESCO.0722.00306.0083;ESCO.0722.00306.0083b_04685;5375;5767;392
ESCO.0722.00306;ESCO.0722.00306.0138;ESCO.0722.00306.0138b_04813;3;539;536
ESCO.0722.00306;ESCO.0722.00306.0211;ESCO.0722.00306.0211b_04877;3;233;230
ESCO.0722.00306;ESCO.0722.00306.0251;ESCO.0722.00306.0251b_04909;2;70;68
ESCO.0722.00306;ESCO.0722.00306.0048;ESCO.0722.00306.0048i_04058;1694;2080;386
ESCO.0722.00306;ESCO.0722.00306.0048;ESCO.0722.00306.0048i_04090;27541;28095;554
ESCO.0722.00306;ESCO.0722.00306.0053;ESCO.0722.00306.0053b_04250;26261;28084;1823
ESCO.0722.00306;ESCO.0722.00306.0086;ESCO.0722.00306.0086b_04698;3;176;173
ESCO.0722.00306;ESCO.0722.00306.0224;ESCO.0722.00306.0224b_04890;2;70;68
ESCO.0722.00306;ESCO.0722.00306.0022;ESCO.0722.00306.0022i_02715;38761;39702;941
ESCO.0722.00306;ESCO.0722.00306.0048;ESCO.0722.00306.0048i_04059;2185;2487;302
ESCO.0722.00306;ESCO.0722.00306.0048;ESCO.0722.00306.0048i_04091;28107;28589;482
ESCO.0722.00306;ESCO.0722.00306.0086;ESCO.0722.00306.0086i_04699;148;591;443
ESCO.0722.00308;ESCO.0722.00308.0019;ESCO.0722.00308.0019i_02835;114009;116201;2192
ESCO.0722.00308;ESCO.0722.00308.0022;ESCO.0722.00308.0022b_02963;18147;18608;461
ESCO.0722.00308;ESCO.0722.00308.0028;ESCO.0722.00308.0028i_03475;45062;45427;365
ESCO.0722.00308;ESCO.0722.00308.0035;ESCO.0722.00308.0035b_03859;2;97;95
ESCO.0722.00308;ESCO.0722.00308.0036;ESCO.0722.00308.0036i_03955;27385;28749;1364
ESCO.0722.00308;ESCO.0722.00308.0036;ESCO.0722.00308.0036i_03987;46627;46944;317
ESCO.0722.00308;ESCO.0722.00308.0051;ESCO.0722.00308.0051i_04467;3499;3945;446
ESCO.0722.00308;ESCO.0722.00308.0220;ESCO.0722.00308.0220b_05139;3;458;455
ESCO.0722.00308;ESCO.0722.00308.0277;ESCO.0722.00308.0277b_05203;3;323;320
ESCO.0722.00308;ESCO.0722.00308.0306;ESCO.0722.00308.0306b_05235;3;176;173
ESCO.0722.00308;ESCO.0722.00308.0336;ESCO.0722.00308.0336b_05267;1;147;146
ESCO.0722.00308;ESCO.0722.00308.0512;ESCO.0722.00308.0512b_05395;3;71;68
ESCO.0722.00308;ESCO.0722.00308.0036;ESCO.0722.00308.0036i_03938;5458;6843;1385
ESCO.0722.00308;ESCO.0722.00308.0036;ESCO.0722.00308.0036i_04002;55183;56163;980
ESCO.0722.00308;ESCO.0722.00308.0050;ESCO.0722.00308.0050i_04450;5010;5489;479
ESCO.0722.00308;ESCO.0722.00308.0054;ESCO.0722.00308.0054i_04546;13574;13915;341
ESCO.0722.00308;ESCO.0722.00308.0093;ESCO.0722.00308.0093b_04898;2549;3223;674
ESCO.0722.00308;ESCO.0722.00308.0143;ESCO.0722.00308.0143b_05026;1;894;893
ESCO.0722.00308;ESCO.0722.00308.0179;ESCO.0722.00308.0179b_05090;506;646;140
ESCO.0722.00308;ESCO.0722.00308.0292;ESCO.0722.00308.0292b_05218;13;309;296
ESCO.0722.00308;ESCO.0722.00308.0353;ESCO.0722.00308.0353b_05282;3;101;98
ESCO.0722.00308;ESCO.0722.00308.0488;ESCO.0722.00308.0488b_05378;3;92;89
ESCO.0722.00308;ESCO.0722.00308.0036;ESCO.0722.00308.0036i_03939;6908;8590;1682
ESCO.0722.00308;ESCO.0722.00308.0036;ESCO.0722.00308.0036i_03971;39168;39326;158
ESCO.0722.00308;ESCO.0722.00308.0036;ESCO.0722.00308.0036i_04003;56160;56813;653
ESCO.0722.00308;ESCO.0722.00308.0050;ESCO.0722.00308.0050i_04451;5486;5920;434
ESCO.0722.00308;ESCO.0722.00308.0094;ESCO.0722.00308.0094b_04899;1;210;209
ESCO.0722.00308;ESCO.0722.00308.0113;ESCO.0722.00308.0113b_04963;1;318;317
ESCO.0722.00308;ESCO.0722.00308.0353;ESCO.0722.00308.0353b_05283;103;237;134
ESCO.0722.00308;ESCO.0722.00308.0393;ESCO.0722.00308.0393b_05315;3;116;113
ESCO.0722.00308;ESCO.0722.00308.0489;ESCO.0722.00308.0489b_05379;3;92;89
ESCO.0722.00308;ESCO.0722.00308.0009;ESCO.0722.00308.0009i_01828;107413;107616;203
ESCO.0722.00308;ESCO.0722.00308.0036;ESCO.0722.00308.0036i_03940;8604;9602;998
ESCO.0722.00308;ESCO.0722.00308.0036;ESCO.0722.00308.0036i_04004;56873;57778;905
ESCO.0722.00308;ESCO.0722.00308.0050;ESCO.0722.00308.0050i_04452;6037;7734;1697
ESCO.0722.00308;ESCO.0722.00308.0125;ESCO.0722.00308.0125b_04996;3;1544;1541
ESCO.0722.00308;ESCO.0722.00308.0181;ESCO.0722.00308.0181b_05092;3;617;614
ESCO.0722.00308;ESCO.0722.00308.0264;ESCO.0722.00308.0264b_05188;2;229;227
ESCO.0722.00308;ESCO.0722.00308.0394;ESCO.0722.00308.0394b_05316;29;217;188
ESCO.0722.00308;ESCO.0722.00308.0438;ESCO.0722.00308.0438b_05348;2;133;131
ESCO.0722.00308;ESCO.0722.00308.0491;ESCO.0722.00308.0491b_05380;3;92;89
ESCO.0722.00308;ESCO.0722.00308.0023;ESCO.0722.00308.0023i_03064;112902;113630;728
ESCO.0722.00308;ESCO.0722.00308.0036;ESCO.0722.00308.0036i_03960;33149;33625;476
ESCO.0722.00308;ESCO.0722.00308.0036;ESCO.0722.00308.0036i_03992;48973;49365;392
ESCO.0722.00308;ESCO.0722.00308.0049;ESCO.0722.00308.0049i_04440;26604;26759;155
ESCO.0722.00308;ESCO.0722.00308.0052;ESCO.0722.00308.0052i_04472;2695;3051;356
ESCO.0722.00308;ESCO.0722.00308.0091;ESCO.0722.00308.0091b_04888;3258;3530;272
ESCO.0722.00308;ESCO.0722.00308.0173;ESCO.0722.00308.0173b_05080;409;708;299
ESCO.0722.00308;ESCO.0722.00308.0226;ESCO.0722.00308.0226b_05144;55;423;368
ESCO.0722.00308;ESCO.0722.00308.0340;ESCO.0722.00308.0340b_05272;2;247;245
ESCO.0722.00308;ESCO.0722.00308.0377;ESCO.0722.00308.0377b_05304;3;227;224
ESCO.0722.00308;ESCO.0722.00308.0422;ESCO.0722.00308.0422b_05336;2;157;155
ESCO.0722.00308;ESCO.0722.00308.0471;ESCO.0722.00308.0471b_05368;3;104;101
ESCO.0722.00308;ESCO.0722.00308.0525;ESCO.0722.00308.0525b_05400;2;61;59
ESCO.0722.00308;ESCO.0722.00308.0023;ESCO.0722.00308.0023b_03065;113632;114036;404
ESCO.0722.00308;ESCO.0722.00308.0036;ESCO.0722.00308.0036i_03961;33622;34116;494
ESCO.0722.00308;ESCO.0722.00308.0036;ESCO.0722.00308.0036i_03993;49386;49994;608
ESCO.0722.00308;ESCO.0722.00308.0138;ESCO.0722.00308.0138b_05017;962;1159;197
ESCO.0722.00308;ESCO.0722.00308.0310;ESCO.0722.00308.0310b_05241;3;284;281
ESCO.0722.00308;ESCO.0722.00308.0341;ESCO.0722.00308.0341b_05273;2;244;242
ESCO.0722.00308;ESCO.0722.00308.0378;ESCO.0722.00308.0378b_05305;2;226;224
ESCO.0722.00308;ESCO.0722.00308.0472;ESCO.0722.00308.0472b_05369;3;101;98
ESCO.0722.00308;ESCO.0722.00308.0003;ESCO.0722.00308.0003i_00465;25443;26681;1238
ESCO.0722.00308;ESCO.0722.00308.0034;ESCO.0722.00308.0034b_03793;3;458;455
ESCO.0722.00308;ESCO.0722.00308.0035;ESCO.0722.00308.0035i_03889;26722;27207;485
ESCO.0722.00308;ESCO.0722.00308.0036;ESCO.0722.00308.0036i_03953;26495;26887;392
ESCO.0722.00308;ESCO.0722.00308.0036;ESCO.0722.00308.0036i_03985;45562;46278;716
ESCO.0722.00308;ESCO.0722.00308.0051;ESCO.0722.00308.0051i_04465;1118;2548;1430
ESCO.0722.00308;ESCO.0722.00308.0054;ESCO.0722.00308.0054i_04529;3628;4002;374
ESCO.0722.00308;ESCO.0722.00308.0118;ESCO.0722.00308.0118b_04977;3;350;347
ESCO.0722.00308;ESCO.0722.00308.0168;ESCO.0722.00308.0168b_05073;493;753;260
ESCO.0722.00308;ESCO.0722.00308.0218;ESCO.0722.00308.0218b_05137;78;461;383
ESCO.0722.00308;ESCO.0722.00308.0368;ESCO.0722.00308.0368b_05297;2;133;131
ESCO.0722.00308;ESCO.0722.00308.0012;ESCO.0722.00308.0012i_02123;81347;81748;401
ESCO.0722.00308;ESCO.0722.00308.0034;ESCO.0722.00308.0034i_03851;61230;61583;353
ESCO.0722.00308;ESCO.0722.00308.0035;ESCO.0722.00308.0035i_03915;53828;54727;899
ESCO.0722.00308;ESCO.0722.00308.0036;ESCO.0722.00308.0036i_03947;19853;20287;434
ESCO.0722.00308;ESCO.0722.00308.0036;ESCO.0722.00308.0036i_03979;42369;42986;617
ESCO.0722.00308;ESCO.0722.00308.0050;ESCO.0722.00308.0050i_04459;12423;13130;707
ESCO.0722.00308;ESCO.0722.00308.0052;ESCO.0722.00308.0052i_04491;21109;21276;167
ESCO.0722.00308;ESCO.0722.00308.0087;ESCO.0722.00308.0087b_04875;1948;2034;86
ESCO.0722.00308;ESCO.0722.00308.0187;ESCO.0722.00308.0187b_05099;3;611;608
ESCO.0722.00308;ESCO.0722.00308.0268;ESCO.0722.00308.0268b_05195;251;334;83
ESCO.0722.00308;ESCO.0722.00308.0299;ESCO.0722.00308.0299b_05227;1;300;299
ESCO.0722.00308;ESCO.0722.00308.0362;ESCO.0722.00308.0362b_05291;1;234;233
ESCO.0722.00308;ESCO.0722.00308.0407;ESCO.0722.00308.0407b_05323;3;191;188
ESCO.0722.00308;ESCO.0722.00308.0451;ESCO.0722.00308.0451b_05355;3;110;107
ESCO.0722.00308;ESCO.0722.00308.0498;ESCO.0722.00308.0498b_05387;3;86;83
ESCO.0722.00308;ESCO.0722.00308.0003;ESCO.0722.00308.0003i_00460;20136;21200;1064
ESCO.0722.00308;ESCO.0722.00308.0035;ESCO.0722.00308.0035i_03884;21628;22923;1295
ESCO.0722.00308;ESCO.0722.00308.0035;ESCO.0722.00308.0035i_03916;54906;55418;512
ESCO.0722.00308;ESCO.0722.00308.0036;ESCO.0722.00308.0036i_03948;20290;20550;260
ESCO.0722.00308;ESCO.0722.00308.0036;ESCO.0722.00308.0036i_03980;42973;43272;299
ESCO.0722.00308;ESCO.0722.00308.0050;ESCO.0722.00308.0050i_04460;13511;14266;755
ESCO.0722.00308;ESCO.0722.00308.0054;ESCO.0722.00308.0054i_04524;444;1019;575
ESCO.0722.00308;ESCO.0722.00308.0148;ESCO.0722.00308.0148b_05036;968;1045;77
ESCO.0722.00308;ESCO.0722.00308.0244;ESCO.0722.00308.0244b_05164;3;383;380
ESCO.0722.00308;ESCO.0722.00308.0269;ESCO.0722.00308.0269b_05196;77;331;254
ESCO.0722.00308;ESCO.0722.00308.0003;ESCO.0722.00308.0003i_00461;21210;22169;959
ESCO.0722.00308;ESCO.0722.00308.0035;ESCO.0722.00308.0035i_03885;22913;23371;458
ESCO.0722.00308;ESCO.0722.00308.0036;ESCO.0722.00308.0036i_03949;20956;21180;224
ESCO.0722.00308;ESCO.0722.00308.0036;ESCO.0722.00308.0036i_03981;43286;44281;995
ESCO.0722.00308;ESCO.0722.00308.0050;ESCO.0722.00308.0050i_04461;14655;15476;821
ESCO.0722.00308;ESCO.0722.00308.0054;ESCO.0722.00308.0054i_04525;1027;2055;1028
ESCO.0722.00308;ESCO.0722.00308.0245;ESCO.0722.00308.0245b_05165;2;382;380
ESCO.0722.00308;ESCO.0722.00308.0364;ESCO.0722.00308.0364b_05293;3;233;230
ESCO.0722.00308;ESCO.0722.00308.0409;ESCO.0722.00308.0409b_05325;2;190;188
ESCO.0722.00308;ESCO.0722.00308.0454;ESCO.0722.00308.0454b_05357;3;110;107
ESCO.0722.00308;ESCO.0722.00308.0500;ESCO.0722.00308.0500b_05389;3;83;80
ESCO.0722.00308;ESCO.0722.00308.0002;ESCO.0722.00308.0002i_00328;240946;241968;1022
ESCO.0722.00308;ESCO.0722.00308.0005;ESCO.0722.00308.0005i_00872;104309;104791;482
ESCO.0722.00308;ESCO.0722.00308.0016;ESCO.0722.00308.0016i_02568;135211;135399;188
ESCO.0722.00308;ESCO.0722.00308.0036;ESCO.0722.00308.0036i_03944;12110;12307;197
ESCO.0722.00308;ESCO.0722.00308.0050;ESCO.0722.00308.0050i_04456;10755;11303;548
ESCO.0722.00308;ESCO.0722.00308.0080;ESCO.0722.00308.0080b_04840;1;552;551
ESCO.0722.00308;ESCO.0722.00308.0095;ESCO.0722.00308.0095b_04904;2;2098;2096
ESCO.0722.00308;ESCO.0722.00308.0165;ESCO.0722.00308.0165b_05064;3;779;776
ESCO.0722.00308;ESCO.0722.00308.0213;ESCO.0722.00308.0213b_05128;2;271;269
ESCO.0722.00308;ESCO.0722.00308.0241;ESCO.0722.00308.0241b_05160;3;386;383
ESCO.0722.00308;ESCO.0722.00308.0358;ESCO.0722.00308.0358b_05288;1;237;236
ESCO.0722.00308;ESCO.0722.00308.0401;ESCO.0722.00308.0401b_05320;1;207;206
ESCO.0722.00308;ESCO.0722.00308.0036;ESCO.0722.00308.0036i_03945;12340;12825;485
ESCO.0722.00308;ESCO.0722.00308.0050;ESCO.0722.00308.0050i_04457;11312;11803;491
ESCO.0722.00308;ESCO.0722.00308.0087;ESCO.0722.00308.0087b_04873;3;116;113
ESCO.0722.00308;ESCO.0722.00308.0242;ESCO.0722.00308.0242b_05161;3;386;383
ESCO.0722.00308;ESCO.0722.00308.0404;ESCO.0722.00308.0404b_05321;3;200;197
ESCO.0722.00308;ESCO.0722.00308.0012;ESCO.0722.00308.0012i_02122;80522;81202;680
ESCO.0722.00308;ESCO.0722.00308.0035;ESCO.0722.00308.0035i_03882;19519;19956;437
ESCO.0722.00308;ESCO.0722.00308.0036;ESCO.0722.00308.0036i_03946;12977;19816;6839
ESCO.0722.00308;ESCO.0722.00308.0036;ESCO.0722.00308.0036i_03978;41878;42372;494
ESCO.0722.00308;ESCO.0722.00308.0050;ESCO.0722.00308.0050i_04458;11856;12407;551
ESCO.0722.00308;ESCO.0722.00308.0052;ESCO.0722.00308.0052i_04490;20800;20958;158
ESCO.0722.00308;ESCO.0722.00308.0054;ESCO.0722.00308.0054b_04522;3;71;68
ESCO.0722.00308;ESCO.0722.00308.0096;ESCO.0722.00308.0096b_04906;3;416;413
ESCO.0722.00308;ESCO.0722.00308.0148;ESCO.0722.00308.0148b_05034;1;150;149
ESCO.0722.00308;ESCO.0722.00308.0243;ESCO.0722.00308.0243b_05162;3;182;179
ESCO.0722.00308;ESCO.0722.00308.0268;ESCO.0722.00308.0268b_05194;1;204;203
ESCO.0722.00308;ESCO.0722.00308.0450;ESCO.0722.00308.0450b_05354;2;112;110
ESCO.0722.00308;ESCO.0722.00308.0019;ESCO.0722.00308.0019i_02834;112934;114016;1082
ESCO.0722.00308;ESCO.0722.00308.0035;ESCO.0722.00308.0035i_03890;27223;27849;626
ESCO.0722.00308;ESCO.0722.00308.0036;ESCO.0722.00308.0036i_03954;26996;27388;392
ESCO.0722.00308;ESCO.0722.00308.0036;ESCO.0722.00308.0036i_03986;46275;46637;362
ESCO.0722.00308;ESCO.0722.00308.0051;ESCO.0722.00308.0051i_04466;2559;3404;845
ESCO.0722.00308;ESCO.0722.00308.0054;ESCO.0722.00308.0054i_04530;4120;4323;203
ESCO.0722.00308;ESCO.0722.00308.0118;ESCO.0722.00308.0118i_04978;352;789;437
ESCO.0722.00308;ESCO.0722.00308.0276;ESCO.0722.00308.0276b_05202;34;324;290
ESCO.0722.00308;ESCO.0722.00308.0305;ESCO.0722.00308.0305b_05234;2;292;290
ESCO.0722.00308;ESCO.0722.00308.0369;ESCO.0722.00308.0369b_05298;3;140;137
ESCO.0722.00308;ESCO.0722.00308.0459;ESCO.0722.00308.0459b_05362;2;109;107
ESCO.0722.00308;ESCO.0722.00308.0011;ESCO.0722.00308.0011i_02013;160152;160376;224
ESCO.0722.00308;ESCO.0722.00308.0036;ESCO.0722.00308.0036i_03933;1677;2003;326
ESCO.0722.00308;ESCO.0722.00308.0036;ESCO.0722.00308.0036i_03997;51582;52778;1196
ESCO.0722.00308;ESCO.0722.00308.0050;ESCO.0722.00308.0050i_04445;1662;2000;338
ESCO.0722.00308;ESCO.0722.00308.0176;ESCO.0722.00308.0176b_05085;1;546;545
ESCO.0722.00308;ESCO.0722.00308.0255;ESCO.0722.00308.0255b_05181;275;352;77
ESCO.0722.00308;ESCO.0722.00308.0314;ESCO.0722.00308.0314b_05245;2;277;275
ESCO.0722.00308;ESCO.0722.00308.0345;ESCO.0722.00308.0345b_05277;3;242;239
ESCO.0722.00308;ESCO.0722.00308.0383;ESCO.0722.00308.0383b_05309;2;223;221
ESCO.0722.00308;ESCO.0722.00308.0478;ESCO.0722.00308.0478b_05373;2;97;95
ESCO.0722.00308;ESCO.0722.00308.0015;ESCO.0722.00308.0015i_02430;20412;20597;185
ESCO.0722.00308;ESCO.0722.00308.0036;ESCO.0722.00308.0036i_03934;2003;2449;446
ESCO.0722.00308;ESCO.0722.00308.0036;ESCO.0722.00308.0036i_03998;52813;53172;359
ESCO.0722.00308;ESCO.0722.00308.0050;ESCO.0722.00308.0050i_04446;2014;2970;956
ESCO.0722.00308;ESCO.0722.00308.0140;ESCO.0722.00308.0140b_05022;230;1150;920
ESCO.0722.00308;ESCO.0722.00308.0159;ESCO.0722.00308.0159b_05054;1;120;119
ESCO.0722.00308;ESCO.0722.00308.0176;ESCO.0722.00308.0176b_05086;536;697;161
ESCO.0722.00308;ESCO.0722.00308.0315;ESCO.0722.00308.0315b_05246;1;276;275
ESCO.0722.00308;ESCO.0722.00308.0002;ESCO.0722.00308.0002i_00127;37379;37840;461
ESCO.0722.00308;ESCO.0722.00308.0010;ESCO.0722.00308.0010b_01855;238;540;302
ESCO.0722.00308;ESCO.0722.00308.0015;ESCO.0722.00308.0015i_02431;20643;21359;716
ESCO.0722.00308;ESCO.0722.00308.0036;ESCO.0722.00308.0036i_03935;2439;3059;620
ESCO.0722.00308;ESCO.0722.00308.0036;ESCO.0722.00308.0036i_03999;53176;53478;302
ESCO.0722.00308;ESCO.0722.00308.0050;ESCO.0722.00308.0050i_04447;3237;3521;284
ESCO.0722.00308;ESCO.0722.00308.0064;ESCO.0722.00308.0064b_04703;12023;12199;176
ESCO.0722.00308;ESCO.0722.00308.0102;ESCO.0722.00308.0102b_04927;3;80;77
ESCO.0722.00308;ESCO.0722.00308.0177;ESCO.0722.00308.0177b_05087;2;682;680
ESCO.0722.00308;ESCO.0722.00308.0234;ESCO.0722.00308.0234b_05151;3;158;155
ESCO.0722.00308;ESCO.0722.00308.0317;ESCO.0722.00308.0317b_05247;1;270;269
ESCO.0722.00308;ESCO.0722.00308.0432;ESCO.0722.00308.0432b_05343;3;149;146
ESCO.0722.00308;ESCO.0722.00308.0483;ESCO.0722.00308.0483b_05375;3;95;92
ESCO.0722.00308;ESCO.0722.00308.0012;ESCO.0722.00308.0012i_02138;95952;96494;542
ESCO.0722.00308;ESCO.0722.00308.0036;ESCO.0722.00308.0036i_03962;34131;34595;464
ESCO.0722.00308;ESCO.0722.00308.0036;ESCO.0722.00308.0036i_03994;50278;50931;653
ESCO.0722.00308;ESCO.0722.00308.0048;ESCO.0722.00308.0048b_04378;34;267;233
ESCO.0722.00308;ESCO.0722.00308.0050;ESCO.0722.00308.0050b_04442;2;184;182
ESCO.0722.00308;ESCO.0722.00308.0069;ESCO.0722.00308.0069b_04762;9982;10167;185
ESCO.0722.00308;ESCO.0722.00308.0254;ESCO.0722.00308.0254b_05178;3;272;269
ESCO.0722.00308;ESCO.0722.00308.0284;ESCO.0722.00308.0284b_05210;1;60;59
ESCO.0722.00308;ESCO.0722.00308.0311;ESCO.0722.00308.0311b_05242;1;285;284
ESCO.0722.00308;ESCO.0722.00308.0380;ESCO.0722.00308.0380b_05306;2;226;224
ESCO.0722.00308;ESCO.0722.00308.0474;ESCO.0722.00308.0474b_05370;2;100;98
ESCO.0722.00308;ESCO.0722.00308.0012;ESCO.0722.00308.0012i_02139;96436;96657;221
ESCO.0722.00308;ESCO.0722.00308.0035;ESCO.0722.00308.0035b_03931;65475;65630;155
ESCO.0722.00308;ESCO.0722.00308.0036;ESCO.0722.00308.0036i_03963;34602;35369;767
ESCO.0722.00308;ESCO.0722.00308.0036;ESCO.0722.00308.0036i_03995;50932;51066;134
ESCO.0722.00308;ESCO.0722.00308.0050;ESCO.0722.00308.0050i_04443;453;740;287
ESCO.0722.00308;ESCO.0722.00308.0110;ESCO.0722.00308.0110b_04955;701;2293;1592
ESCO.0722.00308;ESCO.0722.00308.0156;ESCO.0722.00308.0156b_05051;3;896;893
ESCO.0722.00308;ESCO.0722.00308.0202;ESCO.0722.00308.0202b_05115;3;425;422
ESCO.0722.00308;ESCO.0722.00308.0285;ESCO.0722.00308.0285b_05211;2;313;311
ESCO.0722.00308;ESCO.0722.00308.0312;ESCO.0722.00308.0312b_05243;2;283;281
ESCO.0722.00308;ESCO.0722.00308.0343;ESCO.0722.00308.0343b_05275;128;244;116
ESCO.0722.00308;ESCO.0722.00308.0381;ESCO.0722.00308.0381b_05307;1;225;224
ESCO.0722.00308;ESCO.0722.00308.0008;ESCO.0722.00308.0008i_01724;130037;130144;107
ESCO.0722.00308;ESCO.0722.00308.0011;ESCO.0722.00308.0011i_02012;159553;160152;599
ESCO.0722.00308;ESCO.0722.00308.0011;ESCO.0722.00308.0011b_02044;200430;201599;1169
ESCO.0722.00308;ESCO.0722.00308.0036;ESCO.0722.00308.0036i_03964;35359;36453;1094
ESCO.0722.00308;ESCO.0722.00308.0036;ESCO.0722.00308.0036i_03996;51260;51589;329
ESCO.0722.00308;ESCO.0722.00308.0050;ESCO.0722.00308.0050i_04444;733;1374;641
ESCO.0722.00308;ESCO.0722.00308.0093;ESCO.0722.00308.0093b_04892;2;106;104
ESCO.0722.00308;ESCO.0722.00308.0231;ESCO.0722.00308.0231b_05148;3;404;401
ESCO.0722.00308;ESCO.0722.00308.0313;ESCO.0722.00308.0313b_05244;3;281;278
ESCO.0722.00308;ESCO.0722.00308.0382;ESCO.0722.00308.0382b_05308;1;225;224
ESCO.0722.00308;ESCO.0722.00308.0427;ESCO.0722.00308.0427b_05340;2;151;149
ESCO.0722.00308;ESCO.0722.00308.0036;ESCO.0722.00308.0036i_03941;9803;10765;962
ESCO.0722.00308;ESCO.0722.00308.0036;ESCO.0722.00308.0036i_03973;39632;39802;170
ESCO.0722.00308;ESCO.0722.00308.0036;ESCO.0722.00308.0036i_04005;57762;58442;680
ESCO.0722.00308;ESCO.0722.00308.0050;ESCO.0722.00308.0050i_04453;7881;8159;278
ESCO.0722.00308;ESCO.0722.00308.0062;ESCO.0722.00308.0062b_04677;11720;12778;1058
ESCO.0722.00308;ESCO.0722.00308.0145;ESCO.0722.00308.0145b_05029;34;1104;1070
ESCO.0722.00308;ESCO.0722.00308.0182;ESCO.0722.00308.0182b_05093;1;510;509
ESCO.0722.00308;ESCO.0722.00308.0294;ESCO.0722.00308.0294b_05221;204;305;101
ESCO.0722.00308;ESCO.0722.00308.0395;ESCO.0722.00308.0395b_05317;1;216;215
ESCO.0722.00308;ESCO.0722.00308.0492;ESCO.0722.00308.0492b_05381;1;90;89
ESCO.0722.00308;ESCO.0722.00308.0009;ESCO.0722.00308.0009i_01830;108497;109117;620
ESCO.0722.00308;ESCO.0722.00308.0031;ESCO.0722.00308.0031b_03654;102;587;485
ESCO.0722.00308;ESCO.0722.00308.0035;ESCO.0722.00308.0035i_03910;48805;49479;674
ESCO.0722.00308;ESCO.0722.00308.0036;ESCO.0722.00308.0036i_03942;11179;11403;224
ESCO.0722.00308;ESCO.0722.00308.0036;ESCO.0722.00308.0036b_04006;58435;59340;905
ESCO.0722.00308;ESCO.0722.00308.0050;ESCO.0722.00308.0050i_04454;8227;9885;1658
ESCO.0722.00308;ESCO.0722.00308.0054;ESCO.0722.00308.0054b_04550;18241;18720;479
ESCO.0722.00308;ESCO.0722.00308.0074;ESCO.0722.00308.0074b_04806;5647;6309;662
ESCO.0722.00308;ESCO.0722.00308.0265;ESCO.0722.00308.0265b_05190;48;341;293
ESCO.0722.00308;ESCO.0722.00308.0397;ESCO.0722.00308.0397b_05318;2;211;209
ESCO.0722.00308;ESCO.0722.00308.0441;ESCO.0722.00308.0441b_05350;2;124;122
ESCO.0722.00308;ESCO.0722.00308.0493;ESCO.0722.00308.0493b_05382;3;89;86
ESCO.0722.00308;ESCO.0722.00308.0002;ESCO.0722.00308.0002i_00327;239891;240943;1052
ESCO.0722.00308;ESCO.0722.00308.0005;ESCO.0722.00308.0005i_00871;103275;104246;971
ESCO.0722.00308;ESCO.0722.00308.0016;ESCO.0722.00308.0016i_02567;134836;135207;371
ESCO.0722.00308;ESCO.0722.00308.0035;ESCO.0722.00308.0035i_03911;49476;50009;533
ESCO.0722.00308;ESCO.0722.00308.0036;ESCO.0722.00308.0036i_03943;11403;12110;707
ESCO.0722.00308;ESCO.0722.00308.0037;ESCO.0722.00308.0037b_04007;3;68;65
ESCO.0722.00308;ESCO.0722.00308.0050;ESCO.0722.00308.0050i_04455;9929;10663;734
ESCO.0722.00308;ESCO.0722.00308.0079;ESCO.0722.00308.0079b_04839;5440;5592;152
ESCO.0722.00308;ESCO.0722.00308.0127;ESCO.0722.00308.0127b_04999;2;1507;1505
ESCO.0722.00308;ESCO.0722.00308.0442;ESCO.0722.00308.0442b_05351;60;122;62
ESCO.0722.00308;ESCO.0722.00308.0494;ESCO.0722.00308.0494b_05383;1;90;89
ESCO.0722.00308;ESCO.0722.00308.0003;ESCO.0722.00308.0003i_00464;24306;25433;1127
ESCO.0722.00308;ESCO.0722.00308.0005;ESCO.0722.00308.0005i_00784;14108;14749;641
ESCO.0722.00308;ESCO.0722.00308.0033;ESCO.0722.00308.0033b_03792;8747;9511;764
ESCO.0722.00308;ESCO.0722.00308.0035;ESCO.0722.00308.0035i_03888;26141;26677;536
ESCO.0722.00308;ESCO.0722.00308.0036;ESCO.0722.00308.0036i_03952;25920;26495;575
ESCO.0722.00308;ESCO.0722.00308.0051;ESCO.0722.00308.0051i_04464;747;1121;374
ESCO.0722.00308;ESCO.0722.00308.0054;ESCO.0722.00308.0054i_04528;3146;3589;443
ESCO.0722.00308;ESCO.0722.00308.0064;ESCO.0722.00308.0064b_04688;2;235;233
ESCO.0722.00308;ESCO.0722.00308.0191;ESCO.0722.00308.0191b_05104;488;583;95
ESCO.0722.00308;ESCO.0722.00308.0218;ESCO.0722.00308.0218b_05136;2;88;86
ESCO.0722.00308;ESCO.0722.00308.0274;ESCO.0722.00308.0274b_05200;3;326;323
ESCO.0722.00308;ESCO.0722.00308.0333;ESCO.0722.00308.0333b_05264;117;254;137
ESCO.0722.00308;ESCO.0722.00308.0412;ESCO.0722.00308.0412b_05328;1;177;176
ESCO.0722.00308;ESCO.0722.00308.0457;ESCO.0722.00308.0457b_05360;1;111;110
ESCO.0722.00308;ESCO.0722.00308.0506;ESCO.0722.00308.0506b_05392;3;77;74
ESCO.0722.00308;ESCO.0722.00308.0036;ESCO.0722.00308.0036i_03956;28749;30257;1508
ESCO.0722.00308;ESCO.0722.00308.0036;ESCO.0722.00308.0036i_03988;46941;47564;623
ESCO.0722.00308;ESCO.0722.00308.0051;ESCO.0722.00308.0051b_04468;3948;6080;2132
ESCO.0722.00308;ESCO.0722.00308.0250;ESCO.0722.00308.0250b_05172;2;262;260
ESCO.0722.00308;ESCO.0722.00308.0336;ESCO.0722.00308.0336b_05268;178;252;74
ESCO.0722.00308;ESCO.0722.00308.0036;ESCO.0722.00308.0036i_03957;30283;31320;1037
ESCO.0722.00308;ESCO.0722.00308.0036;ESCO.0722.00308.0036i_03989;47564;47716;152
ESCO.0722.00308;ESCO.0722.00308.0048;ESCO.0722.00308.0048i_04405;24783;25481;698
ESCO.0722.00308;ESCO.0722.00308.0097;ESCO.0722.00308.0097b_04917;2927;3055;128
ESCO.0722.00308;ESCO.0722.00308.0222;ESCO.0722.00308.0222b_05141;1;447;446
ESCO.0722.00308;ESCO.0722.00308.0374;ESCO.0722.00308.0374b_05301;2;226;224
ESCO.0722.00308;ESCO.0722.00308.0468;ESCO.0722.00308.0468b_05365;2;106;104
ESCO.0722.00308;ESCO.0722.00308.0036;ESCO.0722.00308.0036i_03958;31706;32734;1028
ESCO.0722.00308;ESCO.0722.00308.0036;ESCO.0722.00308.0036i_03990;47838;48416;578
ESCO.0722.00308;ESCO.0722.00308.0091;ESCO.0722.00308.0091b_04886;1;96;95
ESCO.0722.00308;ESCO.0722.00308.0136;ESCO.0722.00308.0136b_05014;3;1241;1238
ESCO.0722.00308;ESCO.0722.00308.0154;ESCO.0722.00308.0154b_05046;1;717;716
ESCO.0722.00308;ESCO.0722.00308.0223;ESCO.0722.00308.0223b_05142;2;436;434
ESCO.0722.00308;ESCO.0722.00308.0307;ESCO.0722.00308.0307b_05238;205;288;83
ESCO.0722.00308;ESCO.0722.00308.0419;ESCO.0722.00308.0419b_05334;1;162;161
ESCO.0722.00308;ESCO.0722.00308.0469;ESCO.0722.00308.0469b_05366;1;105;104
ESCO.0722.00308;ESCO.0722.00308.0023;ESCO.0722.00308.0023i_03063;112330;112905;575
ESCO.0722.00308;ESCO.0722.00308.0036;ESCO.0722.00308.0036i_03959;32808;33152;344
ESCO.0722.00308;ESCO.0722.00308.0036;ESCO.0722.00308.0036i_03991;48748;48915;167
ESCO.0722.00308;ESCO.0722.00308.0196;ESCO.0722.00308.0196b_05111;2;550;548
ESCO.0722.00308;ESCO.0722.00308.0308;ESCO.0722.00308.0308b_05239;24;287;263
ESCO.0722.00308;ESCO.0722.00308.0339;ESCO.0722.00308.0339b_05271;164;250;86
ESCO.0722.00308;ESCO.0722.00308.0517;ESCO.0722.00308.0517b_05399;2;67;65
ESCO.0722.00308;ESCO.0722.00308.0036;ESCO.0722.00308.0036i_03936;3052;4989;1937
ESCO.0722.00308;ESCO.0722.00308.0036;ESCO.0722.00308.0036i_04000;53624;54415;791
ESCO.0722.00308;ESCO.0722.00308.0050;ESCO.0722.00308.0050i_04448;3521;4327;806
ESCO.0722.00308;ESCO.0722.00308.0079;ESCO.0722.00308.0079b_04832;1586;1822;236
ESCO.0722.00308;ESCO.0722.00308.0234;ESCO.0722.00308.0234b_05152;183;401;218
ESCO.0722.00308;ESCO.0722.00308.0259;ESCO.0722.00308.0259b_05184;3;347;344
ESCO.0722.00308;ESCO.0722.00308.0290;ESCO.0722.00308.0290b_05216;1;309;308
ESCO.0722.00308;ESCO.0722.00308.0350;ESCO.0722.00308.0350b_05280;2;241;239
ESCO.0722.00308;ESCO.0722.00308.0486;ESCO.0722.00308.0486b_05376;2;94;92
ESCO.0722.00308;ESCO.0722.00308.0001;ESCO.0722.00308.0001b_00001;14;1636;1622
ESCO.0722.00308;ESCO.0722.00308.0009;ESCO.0722.00308.0009i_01825;106357;106674;317
ESCO.0722.00308;ESCO.0722.00308.0036;ESCO.0722.00308.0036i_03937;4989;5363;374
ESCO.0722.00308;ESCO.0722.00308.0036;ESCO.0722.00308.0036i_03969;37998;38714;716
ESCO.0722.00308;ESCO.0722.00308.0036;ESCO.0722.00308.0036i_04001;54412;55179;767
ESCO.0722.00308;ESCO.0722.00308.0050;ESCO.0722.00308.0050i_04449;4404;4856;452
ESCO.0722.00308;ESCO.0722.00308.0054;ESCO.0722.00308.0054i_04545;13237;13515;278
ESCO.0722.00308;ESCO.0722.00308.0291;ESCO.0722.00308.0291b_05217;18;308;290
ESCO.0722.00308;ESCO.0722.00308.0003;ESCO.0722.00308.0003i_00462;22171;23175;1004
ESCO.0722.00308;ESCO.0722.00308.0036;ESCO.0722.00308.0036i_03950;21392;21691;299
ESCO.0722.00308;ESCO.0722.00308.0046;ESCO.0722.00308.0046i_04334;16320;16430;110
ESCO.0722.00308;ESCO.0722.00308.0050;ESCO.0722.00308.0050b_04462;15491;18823;3332
ESCO.0722.00308;ESCO.0722.00308.0052;ESCO.0722.00308.0052b_04494;22856;23707;851
ESCO.0722.00308;ESCO.0722.00308.0168;ESCO.0722.00308.0168b_05070;2;73;71
ESCO.0722.00308;ESCO.0722.00308.0190;ESCO.0722.00308.0190b_05102;1;585;584
ESCO.0722.00308;ESCO.0722.00308.0302;ESCO.0722.00308.0302b_05230;28;297;269
ESCO.0722.00308;ESCO.0722.00308.0410;ESCO.0722.00308.0410b_05326;3;188;185
ESCO.0722.00308;ESCO.0722.00308.0003;ESCO.0722.00308.0003i_00463;23227;24237;1010
ESCO.0722.00308;ESCO.0722.00308.0030;ESCO.0722.00308.0030b_03567;3;98;95
ESCO.0722.00308;ESCO.0722.00308.0035;ESCO.0722.00308.0035i_03887;24985;26079;1094
ESCO.0722.00308;ESCO.0722.00308.0036;ESCO.0722.00308.0036i_03951;21807;23015;1208
ESCO.0722.00308;ESCO.0722.00308.0051;ESCO.0722.00308.0051b_04463;1;741;740
ESCO.0722.00308;ESCO.0722.00308.0191;ESCO.0722.00308.0191b_05103;1;429;428
ESCO.0722.00308;ESCO.0722.00308.0217;ESCO.0722.00308.0217b_05135;363;470;107
ESCO.0722.00308;ESCO.0722.00308.0332;ESCO.0722.00308.0332b_05263;2;253;251
ESCO.0722.00308;ESCO.0722.00308.0366;ESCO.0722.00308.0366b_05295;3;230;227
ESCO.0722.00323;ESCO.0722.00323.0008;ESCO.0722.00323.0008i_01019;44918;46522;1604
ESCO.0722.00323;ESCO.0722.00323.0026;ESCO.0722.00323.0026i_02779;2237;3367;1130
ESCO.0722.00323;ESCO.0722.00323.0036;ESCO.0722.00323.0036i_03483;13550;13750;200
ESCO.0722.00323;ESCO.0722.00323.0053;ESCO.0722.00323.0053i_04219;22875;23588;713
ESCO.0722.00323;ESCO.0722.00323.0056;ESCO.0722.00323.0056i_04315;9932;11659;1727
ESCO.0722.00323;ESCO.0722.00323.0059;ESCO.0722.00323.0059i_04411;16304;16858;554
ESCO.0722.00323;ESCO.0722.00323.0077;ESCO.0722.00323.0077i_04635;3648;4082;434
ESCO.0722.00323;ESCO.0722.00323.0120;ESCO.0722.00323.0120b_04795;2;220;218
ESCO.0722.00323;ESCO.0722.00323.0138;ESCO.0722.00323.0138b_04827;1;132;131
ESCO.0722.00323;ESCO.0722.00323.0165;ESCO.0722.00323.0165b_04859;2;517;515
ESCO.0722.00323;ESCO.0722.00323.0193;ESCO.0722.00323.0193b_04891;233;358;125
ESCO.0722.00323;ESCO.0722.00323.0229;ESCO.0722.00323.0229b_04923;62;259;197
ESCO.0722.00323;ESCO.0722.00323.0321;ESCO.0722.00323.0321b_04987;2;112;110
ESCO.0722.00323;ESCO.0722.00323.0059;ESCO.0722.00323.0059i_04394;4536;4850;314
ESCO.0722.00323;ESCO.0722.00323.0128;ESCO.0722.00323.0128b_04810;1;132;131
ESCO.0722.00323;ESCO.0722.00323.0209;ESCO.0722.00323.0209b_04906;2;253;251
ESCO.0722.00323;ESCO.0722.00323.0296;ESCO.0722.00323.0296b_04970;3;167;164
ESCO.0722.00323;ESCO.0722.00323.0044;ESCO.0722.00323.0044i_03819;25196;25753;557
ESCO.0722.00323;ESCO.0722.00323.0053;ESCO.0722.00323.0053i_04203;9286;10290;1004
ESCO.0722.00323;ESCO.0722.00323.0059;ESCO.0722.00323.0059i_04395;4853;5170;317
ESCO.0722.00323;ESCO.0722.00323.0128;ESCO.0722.00323.0128b_04811;619;1038;419
ESCO.0722.00323;ESCO.0722.00323.0151;ESCO.0722.00323.0151b_04843;3;617;614
ESCO.0722.00323;ESCO.0722.00323.0210;ESCO.0722.00323.0210b_04907;2;289;287
ESCO.0722.00323;ESCO.0722.00323.0252;ESCO.0722.00323.0252b_04939;3;230;227
ESCO.0722.00323;ESCO.0722.00323.0036;ESCO.0722.00323.0036i_03532;63800;64012;212
ESCO.0722.00323;ESCO.0722.00323.0053;ESCO.0722.00323.0053i_04204;11481;11810;329
ESCO.0722.00323;ESCO.0722.00323.0056;ESCO.0722.00323.0056i_04300;3221;3493;272
ESCO.0722.00323;ESCO.0722.00323.0056;ESCO.0722.00323.0056b_04332;24036;24248;212
ESCO.0722.00323;ESCO.0722.00323.0059;ESCO.0722.00323.0059i_04396;5175;5612;437
ESCO.0722.00323;ESCO.0722.00323.0253;ESCO.0722.00323.0253b_04940;2;229;227
ESCO.0722.00323;ESCO.0722.00323.0026;ESCO.0722.00323.0026i_02784;8028;9455;1427
ESCO.0722.00323;ESCO.0722.00323.0029;ESCO.0722.00323.0029i_03136;82590;82775;185
ESCO.0722.00323;ESCO.0722.00323.0053;ESCO.0722.00323.0053i_04192;2393;2827;434
ESCO.0722.00323;ESCO.0722.00323.0053;ESCO.0722.00323.0053i_04224;26745;28028;1283
ESCO.0722.00323;ESCO.0722.00323.0056;ESCO.0722.00323.0056i_04320;14758;14949;191
ESCO.0722.00323;ESCO.0722.00323.0059;ESCO.0722.00323.0059b_04384;3;119;116
ESCO.0722.00323;ESCO.0722.00323.0069;ESCO.0722.00323.0069i_04544;1424;1930;506
ESCO.0722.00323;ESCO.0722.00323.0281;ESCO.0722.00323.0281b_04960;3;146;143
ESCO.0722.00323;ESCO.0722.00323.0026;ESCO.0722.00323.0026i_02785;9552;11723;2171
ESCO.0722.00323;ESCO.0722.00323.0029;ESCO.0722.00323.0029i_03137;83566;84027;461
ESCO.0722.00323;ESCO.0722.00323.0053;ESCO.0722.00323.0053i_04193;2883;3137;254
ESCO.0722.00323;ESCO.0722.00323.0053;ESCO.0722.00323.0053i_04225;28028;29062;1034
ESCO.0722.00323;ESCO.0722.00323.0056;ESCO.0722.00323.0056i_04321;14933;16198;1265
ESCO.0722.00323;ESCO.0722.00323.0059;ESCO.0722.00323.0059i_04385;178;1062;884
ESCO.0722.00323;ESCO.0722.00323.0063;ESCO.0722.00323.0063i_04481;14797;15012;215
ESCO.0722.00323;ESCO.0722.00323.0200;ESCO.0722.00323.0200b_04897;2;325;323
ESCO.0722.00323;ESCO.0722.00323.0238;ESCO.0722.00323.0238b_04929;82;246;164
ESCO.0722.00323;ESCO.0722.00323.0335;ESCO.0722.00323.0335b_04993;3;101;98
ESCO.0722.00323;ESCO.0722.00323.0015;ESCO.0722.00323.0015i_02009;109147;111090;1943
ESCO.0722.00323;ESCO.0722.00323.0026;ESCO.0722.00323.0026i_02777;1340;1831;491
ESCO.0722.00323;ESCO.0722.00323.0028;ESCO.0722.00323.0028i_03033;64833;65270;437
ESCO.0722.00323;ESCO.0722.00323.0036;ESCO.0722.00323.0036i_03481;11554;12624;1070
ESCO.0722.00323;ESCO.0722.00323.0036;ESCO.0722.00323.0036i_03545;71809;71922;113
ESCO.0722.00323;ESCO.0722.00323.0044;ESCO.0722.00323.0044i_03833;33695;33943;248
ESCO.0722.00323;ESCO.0722.00323.0053;ESCO.0722.00323.0053i_04217;19827;20114;287
ESCO.0722.00323;ESCO.0722.00323.0056;ESCO.0722.00323.0056i_04313;8720;9184;464
ESCO.0722.00323;ESCO.0722.00323.0059;ESCO.0722.00323.0059i_04409;14163;15317;1154
ESCO.0722.00323;ESCO.0722.00323.0077;ESCO.0722.00323.0077i_04633;2555;2923;368
ESCO.0722.00323;ESCO.0722.00323.0082;ESCO.0722.00323.0082b_04665;4632;6227;1595
ESCO.0722.00323;ESCO.0722.00323.0096;ESCO.0722.00323.0096b_04729;1092;1553;461
ESCO.0722.00323;ESCO.0722.00323.0106;ESCO.0722.00323.0106b_04761;3;1877;1874
ESCO.0722.00323;ESCO.0722.00323.0192;ESCO.0722.00323.0192b_04889;321;380;59
ESCO.0722.00323;ESCO.0722.00323.0273;ESCO.0722.00323.0273b_04953;2;214;212
ESCO.0722.00323;ESCO.0722.00323.0015;ESCO.0722.00323.0015i_02003;105904;106170;266
ESCO.0722.00323;ESCO.0722.00323.0036;ESCO.0722.00323.0036i_03539;67954;68106;152
ESCO.0722.00323;ESCO.0722.00323.0056;ESCO.0722.00323.0056i_04307;5999;6298;299
ESCO.0722.00323;ESCO.0722.00323.0059;ESCO.0722.00323.0059i_04403;10283;10990;707
ESCO.0722.00323;ESCO.0722.00323.0077;ESCO.0722.00323.0077b_04627;115;402;287
ESCO.0722.00323;ESCO.0722.00323.0095;ESCO.0722.00323.0095i_04723;1764;2243;479
ESCO.0722.00323;ESCO.0722.00323.0310;ESCO.0722.00323.0310b_04979;3;137;134
ESCO.0722.00323;ESCO.0722.00323.0008;ESCO.0722.00323.0008i_01012;38066;38257;191
ESCO.0722.00323;ESCO.0722.00323.0036;ESCO.0722.00323.0036i_03540;68308;68682;374
ESCO.0722.00323;ESCO.0722.00323.0056;ESCO.0722.00323.0056i_04308;6295;6645;350
ESCO.0722.00323;ESCO.0722.00323.0059;ESCO.0722.00323.0059i_04404;10994;11230;236
ESCO.0722.00323;ESCO.0722.00323.0065;ESCO.0722.00323.0065i_04500;3411;3812;401
ESCO.0722.00323;ESCO.0722.00323.0077;ESCO.0722.00323.0077i_04628;457;699;242
ESCO.0722.00323;ESCO.0722.00323.0095;ESCO.0722.00323.0095i_04724;2310;2612;302
ESCO.0722.00323;ESCO.0722.00323.0263;ESCO.0722.00323.0263b_04948;2;223;221
ESCO.0722.00323;ESCO.0722.00323.0009;ESCO.0722.00323.0009b_01141;3;1187;1184
ESCO.0722.00323;ESCO.0722.00323.0009;ESCO.0722.00323.0009i_01205;69857;70003;146
ESCO.0722.00323;ESCO.0722.00323.0035;ESCO.0722.00323.0035i_03413;16007;16582;575
ESCO.0722.00323;ESCO.0722.00323.0036;ESCO.0722.00323.0036i_03541;68787;69053;266
ESCO.0722.00323;ESCO.0722.00323.0053;ESCO.0722.00323.0053i_04213;16149;16691;542
ESCO.0722.00323;ESCO.0722.00323.0059;ESCO.0722.00323.0059i_04405;11249;12292;1043
ESCO.0722.00323;ESCO.0722.00323.0065;ESCO.0722.00323.0065i_04501;3739;4884;1145
ESCO.0722.00323;ESCO.0722.00323.0077;ESCO.0722.00323.0077i_04629;852;1007;155
ESCO.0722.00323;ESCO.0722.00323.0095;ESCO.0722.00323.0095b_04725;2627;2968;341
ESCO.0722.00323;ESCO.0722.00323.0117;ESCO.0722.00323.0117i_04789;734;1048;314
ESCO.0722.00323;ESCO.0722.00323.0133;ESCO.0722.00323.0133b_04821;609;1070;461
ESCO.0722.00323;ESCO.0722.00323.0161;ESCO.0722.00323.0161b_04853;1;540;539
ESCO.0722.00323;ESCO.0722.00323.0008;ESCO.0722.00323.0008i_01008;34821;35675;854
ESCO.0722.00323;ESCO.0722.00323.0029;ESCO.0722.00323.0029i_03088;11178;14732;3554
ESCO.0722.00323;ESCO.0722.00323.0029;ESCO.0722.00323.0029i_03152;102031;102528;497
ESCO.0722.00323;ESCO.0722.00323.0036;ESCO.0722.00323.0036i_03536;66927;67550;623
ESCO.0722.00323;ESCO.0722.00323.0056;ESCO.0722.00323.0056i_04304;4898;5440;542
ESCO.0722.00323;ESCO.0722.00323.0059;ESCO.0722.00323.0059i_04400;6987;7277;290
ESCO.0722.00323;ESCO.0722.00323.0095;ESCO.0722.00323.0095b_04720;116;385;269
ESCO.0722.00323;ESCO.0722.00323.0131;ESCO.0722.00323.0131i_04816;155;607;452
ESCO.0722.00323;ESCO.0722.00323.0157;ESCO.0722.00323.0157b_04848;44;577;533
ESCO.0722.00323;ESCO.0722.00323.0259;ESCO.0722.00323.0259b_04944;2;223;221
ESCO.0722.00323;ESCO.0722.00323.0036;ESCO.0722.00323.0036i_03537;67534;67632;98
ESCO.0722.00323;ESCO.0722.00323.0056;ESCO.0722.00323.0056i_04305;5464;5733;269
ESCO.0722.00323;ESCO.0722.00323.0059;ESCO.0722.00323.0059i_04401;7329;7643;314
ESCO.0722.00323;ESCO.0722.00323.0095;ESCO.0722.00323.0095i_04721;474;689;215
ESCO.0722.00323;ESCO.0722.00323.0131;ESCO.0722.00323.0131b_04817;637;1098;461
ESCO.0722.00323;ESCO.0722.00323.0158;ESCO.0722.00323.0158b_04849;3;71;68
ESCO.0722.00323;ESCO.0722.00323.0218;ESCO.0722.00323.0218b_04913;3;275;272
ESCO.0722.00323;ESCO.0722.00323.0015;ESCO.0722.00323.0015i_02002;105634;105843;209
ESCO.0722.00323;ESCO.0722.00323.0029;ESCO.0722.00323.0029i_03090;17858;18364;506
ESCO.0722.00323;ESCO.0722.00323.0036;ESCO.0722.00323.0036i_03538;67747;67884;137
ESCO.0722.00323;ESCO.0722.00323.0056;ESCO.0722.00323.0056i_04306;5723;5968;245
ESCO.0722.00323;ESCO.0722.00323.0058;ESCO.0722.00323.0058i_04370;9454;9708;254
ESCO.0722.00323;ESCO.0722.00323.0059;ESCO.0722.00323.0059i_04402;7643;10273;2630
ESCO.0722.00323;ESCO.0722.00323.0076;ESCO.0722.00323.0076b_04626;7614;7766;152
ESCO.0722.00323;ESCO.0722.00323.0095;ESCO.0722.00323.0095i_04722;882;1706;824
ESCO.0722.00323;ESCO.0722.00323.0261;ESCO.0722.00323.0261b_04946;2;223;221
ESCO.0722.00323;ESCO.0722.00323.0015;ESCO.0722.00323.0015i_02010;111035;111847;812
ESCO.0722.00323;ESCO.0722.00323.0026;ESCO.0722.00323.0026i_02778;1882;2175;293
ESCO.0722.00323;ESCO.0722.00323.0036;ESCO.0722.00323.0036i_03482;12910;13545;635
ESCO.0722.00323;ESCO.0722.00323.0036;ESCO.0722.00323.0036b_03546;72302;72871;569
ESCO.0722.00323;ESCO.0722.00323.0043;ESCO.0722.00323.0043b_03738;115;300;185
ESCO.0722.00323;ESCO.0722.00323.0044;ESCO.0722.00323.0044i_03834;33987;34268;281
ESCO.0722.00323;ESCO.0722.00323.0052;ESCO.0722.00323.0052i_04154;248;541;293
ESCO.0722.00323;ESCO.0722.00323.0053;ESCO.0722.00323.0053i_04218;20130;22865;2735
ESCO.0722.00323;ESCO.0722.00323.0056;ESCO.0722.00323.0056i_04314;9188;9922;734
ESCO.0722.00323;ESCO.0722.00323.0059;ESCO.0722.00323.0059i_04410;15310;16341;1031
ESCO.0722.00323;ESCO.0722.00323.0071;ESCO.0722.00323.0071b_04570;6;104;98
ESCO.0722.00323;ESCO.0722.00323.0077;ESCO.0722.00323.0077i_04634;2925;3635;710
ESCO.0722.00323;ESCO.0722.00323.0097;ESCO.0722.00323.0097b_04730;1;108;107
ESCO.0722.00323;ESCO.0722.00323.0119;ESCO.0722.00323.0119b_04794;949;1482;533
ESCO.0722.00323;ESCO.0722.00323.0228;ESCO.0722.00323.0228b_04922;1;261;260
ESCO.0722.00323;ESCO.0722.00323.0274;ESCO.0722.00323.0274b_04954;58;213;155
ESCO.0722.00323;ESCO.0722.00323.0029;ESCO.0722.00323.0029i_03141;88576;90321;1745
ESCO.0722.00323;ESCO.0722.00323.0056;ESCO.0722.00323.0056i_04325;18014;19081;1067
ESCO.0722.00323;ESCO.0722.00323.0058;ESCO.0722.00323.0058b_04357;47;511;464
ESCO.0722.00323;ESCO.0722.00323.0059;ESCO.0722.00323.0059i_04389;2388;2645;257
ESCO.0722.00323;ESCO.0722.00323.0092;ESCO.0722.00323.0092i_04709;3562;3774;212
ESCO.0722.00323;ESCO.0722.00323.0110;ESCO.0722.00323.0110b_04773;1853;2008;155
ESCO.0722.00323;ESCO.0722.00323.0026;ESCO.0722.00323.0026i_02790;15876;16169;293
ESCO.0722.00323;ESCO.0722.00323.0029;ESCO.0722.00323.0029i_03142;90382;91275;893
ESCO.0722.00323;ESCO.0722.00323.0044;ESCO.0722.00323.0044i_03846;39883;40005;122
ESCO.0722.00323;ESCO.0722.00323.0056;ESCO.0722.00323.0056i_04326;19094;19321;227
ESCO.0722.00323;ESCO.0722.00323.0059;ESCO.0722.00323.0059i_04390;2635;2961;326
ESCO.0722.00323;ESCO.0722.00323.0069;ESCO.0722.00323.0069i_04550;6486;7826;1340
ESCO.0722.00323;ESCO.0722.00323.0100;ESCO.0722.00323.0100i_04742;595;957;362
ESCO.0722.00323;ESCO.0722.00323.0125;ESCO.0722.00323.0125b_04806;62;484;422
ESCO.0722.00323;ESCO.0722.00323.0147;ESCO.0722.00323.0147b_04838;3;296;293
ESCO.0722.00323;ESCO.0722.00323.0291;ESCO.0722.00323.0291b_04966;2;127;125
ESCO.0722.00323;ESCO.0722.00323.0351;ESCO.0722.00323.0351b_04998;3;74;71
ESCO.0722.00323;ESCO.0722.00323.0029;ESCO.0722.00323.0029i_03143;91291;92253;962
ESCO.0722.00323;ESCO.0722.00323.0044;ESCO.0722.00323.0044i_03847;40199;40588;389
ESCO.0722.00323;ESCO.0722.00323.0053;ESCO.0722.00323.0053i_04231;32409;32717;308
ESCO.0722.00323;ESCO.0722.00323.0015;ESCO.0722.00323.0015i_01954;50892;51128;236
ESCO.0722.00323;ESCO.0722.00323.0026;ESCO.0722.00323.0026i_02786;11741;12175;434
ESCO.0722.00323;ESCO.0722.00323.0029;ESCO.0722.00323.0029i_03138;84014;85783;1769
ESCO.0722.00323;ESCO.0722.00323.0035;ESCO.0722.00323.0035i_03394;4292;4624;332
ESCO.0722.00323;ESCO.0722.00323.0036;ESCO.0722.00323.0036i_03490;20986;21195;209
ESCO.0722.00323;ESCO.0722.00323.0053;ESCO.0722.00323.0053i_04194;3492;4448;956
ESCO.0722.00323;ESCO.0722.00323.0053;ESCO.0722.00323.0053i_04226;29049;30881;1832
ESCO.0722.00323;ESCO.0722.00323.0059;ESCO.0722.00323.0059i_04386;1095;1679;584
ESCO.0722.00323;ESCO.0722.00323.0071;ESCO.0722.00323.0071i_04578;6303;8027;1724
ESCO.0722.00323;ESCO.0722.00323.0143;ESCO.0722.00323.0143b_04834;3;914;911
ESCO.0722.00323;ESCO.0722.00323.0286;ESCO.0722.00323.0286b_04962;20;205;185
ESCO.0722.00323;ESCO.0722.00323.0338;ESCO.0722.00323.0338b_04994;1;99;98
ESCO.0722.00323;ESCO.0722.00323.0029;ESCO.0722.00323.0029i_03139;85783;87081;1298
ESCO.0722.00323;ESCO.0722.00323.0036;ESCO.0722.00323.0036i_03491;21293;21907;614
ESCO.0722.00323;ESCO.0722.00323.0053;ESCO.0722.00323.0053i_04227;30895;31431;536
ESCO.0722.00323;ESCO.0722.00323.0059;ESCO.0722.00323.0059i_04387;1893;2099;206
ESCO.0722.00323;ESCO.0722.00323.0092;ESCO.0722.00323.0092i_04707;1907;2224;317
ESCO.0722.00323;ESCO.0722.00323.0201;ESCO.0722.00323.0201b_04899;115;324;209
ESCO.0722.00323;ESCO.0722.00323.0287;ESCO.0722.00323.0287b_04963;1;204;203
ESCO.0722.00323;ESCO.0722.00323.0344;ESCO.0722.00323.0344b_04995;2;94;92
ESCO.0722.00323;ESCO.0722.00323.0029;ESCO.0722.00323.0029i_03140;87081;88166;1085
ESCO.0722.00323;ESCO.0722.00323.0053;ESCO.0722.00323.0053i_04228;31493;31741;248
ESCO.0722.00323;ESCO.0722.00323.0056;ESCO.0722.00323.0056i_04324;17821;17964;143
ESCO.0722.00323;ESCO.0722.00323.0059;ESCO.0722.00323.0059i_04388;2131;2376;245
ESCO.0722.00323;ESCO.0722.00323.0202;ESCO.0722.00323.0202b_04900;172;288;116
ESCO.0722.00323;ESCO.0722.00323.0242;ESCO.0722.00323.0242b_04932;3;206;203
ESCO.0722.00323;ESCO.0722.00323.0347;ESCO.0722.00323.0347b_04996;2;88;86
ESCO.0722.00323;ESCO.0722.00323.0029;ESCO.0722.00323.0029i_03085;9588;10145;557
ESCO.0722.00323;ESCO.0722.00323.0036;ESCO.0722.00323.0036i_03533;64204;64632;428
ESCO.0722.00323;ESCO.0722.00323.0046;ESCO.0722.00323.0046i_03917;5554;5802;248
ESCO.0722.00323;ESCO.0722.00323.0053;ESCO.0722.00323.0053i_04205;11791;12072;281
ESCO.0722.00323;ESCO.0722.00323.0056;ESCO.0722.00323.0056i_04301;3567;3866;299
ESCO.0722.00323;ESCO.0722.00323.0059;ESCO.0722.00323.0059i_04397;5624;5860;236
ESCO.0722.00323;ESCO.0722.00323.0060;ESCO.0722.00323.0060i_04429;11260;13218;1958
ESCO.0722.00323;ESCO.0722.00323.0070;ESCO.0722.00323.0070b_04557;91;387;296
ESCO.0722.00323;ESCO.0722.00323.0113;ESCO.0722.00323.0113b_04781;1393;1530;137
ESCO.0722.00323;ESCO.0722.00323.0213;ESCO.0722.00323.0213b_04909;3;281;278
ESCO.0722.00323;ESCO.0722.00323.0256;ESCO.0722.00323.0256b_04941;1;228;227
ESCO.0722.00323;ESCO.0722.00323.0005;ESCO.0722.00323.0005b_00622;29;847;818
ESCO.0722.00323;ESCO.0722.00323.0029;ESCO.0722.00323.0029i_03086;10142;10714;572
ESCO.0722.00323;ESCO.0722.00323.0036;ESCO.0722.00323.0036i_03534;65214;66227;1013
ESCO.0722.00323;ESCO.0722.00323.0059;ESCO.0722.00323.0059i_04398;5923;6663;740
ESCO.0722.00323;ESCO.0722.00323.0060;ESCO.0722.00323.0060i_04430;13333;14085;752
ESCO.0722.00323;ESCO.0722.00323.0063;ESCO.0722.00323.0063i_04462;5128;5565;437
ESCO.0722.00323;ESCO.0722.00323.0130;ESCO.0722.00323.0130b_04814;1109;1201;92
ESCO.0722.00323;ESCO.0722.00323.0257;ESCO.0722.00323.0257b_04942;3;227;224
ESCO.0722.00323;ESCO.0722.00323.0029;ESCO.0722.00323.0029i_03087;10787;11170;383
ESCO.0722.00323;ESCO.0722.00323.0036;ESCO.0722.00323.0036i_03535;66220;66435;215
ESCO.0722.00323;ESCO.0722.00323.0059;ESCO.0722.00323.0059i_04399;6686;7003;317
ESCO.0722.00323;ESCO.0722.00323.0060;ESCO.0722.00323.0060i_04431;14148;14525;377
ESCO.0722.00323;ESCO.0722.00323.0131;ESCO.0722.00323.0131b_04815;2;127;125
ESCO.0722.00323;ESCO.0722.00323.0258;ESCO.0722.00323.0258b_04943;1;225;224
ESCO.0722.00323;ESCO.0722.00323.0026;ESCO.0722.00323.0026i_02776;1104;1343;239
ESCO.0722.00323;ESCO.0722.00323.0028;ESCO.0722.00323.0028i_03032;64482;64808;326
ESCO.0722.00323;ESCO.0722.00323.0036;ESCO.0722.00323.0036i_03480;9365;11554;2189
ESCO.0722.00323;ESCO.0722.00323.0036;ESCO.0722.00323.0036i_03544;70843;71721;878
ESCO.0722.00323;ESCO.0722.00323.0053;ESCO.0722.00323.0053i_04216;19228;19830;602
ESCO.0722.00323;ESCO.0722.00323.0056;ESCO.0722.00323.0056i_04312;8195;8710;515
ESCO.0722.00323;ESCO.0722.00323.0058;ESCO.0722.00323.0058i_04376;12509;13012;503
ESCO.0722.00323;ESCO.0722.00323.0059;ESCO.0722.00323.0059i_04408;13279;14166;887
ESCO.0722.00323;ESCO.0722.00323.0070;ESCO.0722.00323.0070i_04568;9071;9955;884
ESCO.0722.00323;ESCO.0722.00323.0077;ESCO.0722.00323.0077i_04632;1571;2341;770
ESCO.0722.00323;ESCO.0722.00323.0163;ESCO.0722.00323.0163b_04856;1;528;527
ESCO.0722.00323;ESCO.0722.00323.0272;ESCO.0722.00323.0272b_04952;1;213;212
ESCO.0722.00323;ESCO.0722.00323.0026;ESCO.0722.00323.0026i_02780;3364;4479;1115
ESCO.0722.00323;ESCO.0722.00323.0029;ESCO.0722.00323.0029i_03132;75870;79394;3524
ESCO.0722.00323;ESCO.0722.00323.0052;ESCO.0722.00323.0052i_04156;2330;2599;269
ESCO.0722.00323;ESCO.0722.00323.0053;ESCO.0722.00323.0053i_04220;23589;23852;263
ESCO.0722.00323;ESCO.0722.00323.0056;ESCO.0722.00323.0056i_04316;12469;12774;305
ESCO.0722.00323;ESCO.0722.00323.0059;ESCO.0722.00323.0059i_04412;16871;17353;482
ESCO.0722.00323;ESCO.0722.00323.0077;ESCO.0722.00323.0077i_04636;4569;4916;347
ESCO.0722.00323;ESCO.0722.00323.0276;ESCO.0722.00323.0276b_04956;2;211;209
ESCO.0722.00323;ESCO.0722.00323.0026;ESCO.0722.00323.0026i_02781;4472;5689;1217
ESCO.0722.00323;ESCO.0722.00323.0029;ESCO.0722.00323.0029i_03133;79378;80157;779
ESCO.0722.00323;ESCO.0722.00323.0053;ESCO.0722.00323.0053i_04221;23912;24976;1064
ESCO.0722.00323;ESCO.0722.00323.0056;ESCO.0722.00323.0056i_04317;12802;13017;215
ESCO.0722.00323;ESCO.0722.00323.0059;ESCO.0722.00323.0059i_04413;17365;17559;194
ESCO.0722.00323;ESCO.0722.00323.0077;ESCO.0722.00323.0077i_04637;4909;6486;1577
ESCO.0722.00323;ESCO.0722.00323.0195;ESCO.0722.00323.0195b_04893;3;347;344
ESCO.0722.00323;ESCO.0722.00323.0233;ESCO.0722.00323.0233b_04925;191;253;62
ESCO.0722.00323;ESCO.0722.00323.0277;ESCO.0722.00323.0277b_04957;3;212;209
ESCO.0722.00323;ESCO.0722.00323.0326;ESCO.0722.00323.0326b_04989;2;109;107
ESCO.0722.00323;ESCO.0722.00323.0026;ESCO.0722.00323.0026i_02782;5686;6966;1280
ESCO.0722.00323;ESCO.0722.00323.0052;ESCO.0722.00323.0052b_04190;34292;34432;140
ESCO.0722.00323;ESCO.0722.00323.0053;ESCO.0722.00323.0053i_04222;25161;25850;689
ESCO.0722.00323;ESCO.0722.00323.0056;ESCO.0722.00323.0056i_04318;13348;13746;398
ESCO.0722.00323;ESCO.0722.00323.0059;ESCO.0722.00323.0059b_04414;17837;18097;260
ESCO.0722.00323;ESCO.0722.00323.0065;ESCO.0722.00323.0065b_04510;12519;13760;1241
ESCO.0722.00323;ESCO.0722.00323.0069;ESCO.0722.00323.0069b_04542;1;444;443
ESCO.0722.00323;ESCO.0722.00323.0077;ESCO.0722.00323.0077b_04638;6489;9146;2657
ESCO.0722.00323;ESCO.0722.00323.0140;ESCO.0722.00323.0140b_04830;1;984;983
ESCO.0722.00323;ESCO.0722.00323.0167;ESCO.0722.00323.0167b_04862;3;242;239
ESCO.0722.00323;ESCO.0722.00323.0234;ESCO.0722.00323.0234b_04926;3;251;248
ESCO.0722.00323;ESCO.0722.00323.0278;ESCO.0722.00323.0278b_04958;2;211;209
ESCO.0722.00323;ESCO.0722.00323.0026;ESCO.0722.00323.0026i_02783;7082;8002;920
ESCO.0722.00323;ESCO.0722.00323.0029;ESCO.0722.00323.0029i_03135;82249;82608;359
ESCO.0722.00323;ESCO.0722.00323.0036;ESCO.0722.00323.0036i_03487;19200;19334;134
ESCO.0722.00323;ESCO.0722.00323.0053;ESCO.0722.00323.0053i_04223;25847;26755;908
ESCO.0722.00323;ESCO.0722.00323.0066;ESCO.0722.00323.0066b_04511;62;742;680
ESCO.0722.00323;ESCO.0722.00323.0069;ESCO.0722.00323.0069i_04543;434;1225;791
ESCO.0722.00323;ESCO.0722.00323.0279;ESCO.0722.00323.0279b_04959;2;211;209
ESCO.0722.00323;ESCO.0722.00323.0056;ESCO.0722.00323.0056i_04327;19333;20037;704
ESCO.0722.00323;ESCO.0722.00323.0059;ESCO.0722.00323.0059i_04391;2970;3407;437
ESCO.0722.00323;ESCO.0722.00323.0069;ESCO.0722.00323.0069i_04551;8209;8844;635
ESCO.0722.00323;ESCO.0722.00323.0075;ESCO.0722.00323.0075b_04615;396;866;470
ESCO.0722.00323;ESCO.0722.00323.0079;ESCO.0722.00323.0079b_04647;275;8086;7811
ESCO.0722.00323;ESCO.0722.00323.0100;ESCO.0722.00323.0100i_04743;1027;1338;311
ESCO.0722.00323;ESCO.0722.00323.0125;ESCO.0722.00323.0125b_04807;939;1043;104
ESCO.0722.00323;ESCO.0722.00323.0206;ESCO.0722.00323.0206b_04903;2;307;305
ESCO.0722.00323;ESCO.0722.00323.0246;ESCO.0722.00323.0246b_04935;2;238;236
ESCO.0722.00323;ESCO.0722.00323.0292;ESCO.0722.00323.0292b_04967;3;185;182
ESCO.0722.00323;ESCO.0722.00323.0356;ESCO.0722.00323.0356b_04999;2;70;68
ESCO.0722.00323;ESCO.0722.00323.0053;ESCO.0722.00323.0053i_04200;7917;8138;221
ESCO.0722.00323;ESCO.0722.00323.0059;ESCO.0722.00323.0059i_04392;3433;3834;401
ESCO.0722.00323;ESCO.0722.00323.0069;ESCO.0722.00323.0069i_04552;9082;9249;167
ESCO.0722.00323;ESCO.0722.00323.0100;ESCO.0722.00323.0100i_04744;1397;1555;158
ESCO.0722.00323;ESCO.0722.00323.0148;ESCO.0722.00323.0148b_04840;67;672;605
ESCO.0722.00323;ESCO.0722.00323.0247;ESCO.0722.00323.0247b_04936;25;240;215
ESCO.0722.00323;ESCO.0722.00323.0293;ESCO.0722.00323.0293b_04968;2;139;137
ESCO.0722.00323;ESCO.0722.00323.0359;ESCO.0722.00323.0359b_05000;1;66;65
ESCO.0722.00323;ESCO.0722.00323.0053;ESCO.0722.00323.0053i_04233;33216;33536;320
ESCO.0722.00323;ESCO.0722.00323.0055;ESCO.0722.00323.0055b_04265;193;384;191
ESCO.0722.00323;ESCO.0722.00323.0056;ESCO.0722.00323.0056b_04297;3;392;389
ESCO.0722.00323;ESCO.0722.00323.0063;ESCO.0722.00323.0063b_04457;1;2520;2519
ESCO.0722.00323;ESCO.0722.00323.0069;ESCO.0722.00323.0069i_04553;9582;10340;758
ESCO.0722.00323;ESCO.0722.00323.0208;ESCO.0722.00323.0208b_04905;3;299;296
ESCO.0722.00323;ESCO.0722.00323.0360;ESCO.0722.00323.0360b_05001;1;66;65
ESCO.0722.00323;ESCO.0722.00323.0026;ESCO.0722.00323.0026b_02774;130;267;137
ESCO.0722.00323;ESCO.0722.00323.0036;ESCO.0722.00323.0036i_03542;69341;69739;398
ESCO.0722.00323;ESCO.0722.00323.0053;ESCO.0722.00323.0053i_04214;16694;17848;1154
ESCO.0722.00323;ESCO.0722.00323.0059;ESCO.0722.00323.0059i_04406;12387;12557;170
ESCO.0722.00323;ESCO.0722.00323.0070;ESCO.0722.00323.0070i_04566;7207;7410;203
ESCO.0722.00323;ESCO.0722.00323.0077;ESCO.0722.00323.0077i_04630;1080;1337;257
ESCO.0722.00323;ESCO.0722.00323.0270;ESCO.0722.00323.0270b_04950;3;215;212
ESCO.0722.00323;ESCO.0722.00323.0015;ESCO.0722.00323.0015i_02007;108418;108540;122
ESCO.0722.00323;ESCO.0722.00323.0026;ESCO.0722.00323.0026i_02775;330;1034;704
ESCO.0722.00323;ESCO.0722.00323.0036;ESCO.0722.00323.0036i_03479;8743;9315;572
ESCO.0722.00323;ESCO.0722.00323.0036;ESCO.0722.00323.0036i_03543;70078;70626;548
ESCO.0722.00323;ESCO.0722.00323.0053;ESCO.0722.00323.0053i_04215;18669;19118;449
ESCO.0722.00323;ESCO.0722.00323.0056;ESCO.0722.00323.0056i_04311;7963;8226;263
ESCO.0722.00323;ESCO.0722.00323.0058;ESCO.0722.00323.0058i_04375;11929;12144;215
ESCO.0722.00323;ESCO.0722.00323.0059;ESCO.0722.00323.0059i_04407;12560;13276;716
ESCO.0722.00323;ESCO.0722.00323.0070;ESCO.0722.00323.0070i_04567;7318;8526;1208
ESCO.0722.00323;ESCO.0722.00323.0077;ESCO.0722.00323.0077i_04631;1279;1530;251
ESCO.0722.00331;ESCO.0722.00331.0013;ESCO.0722.00331.0013i_01202;43000;44163;1163
ESCO.0722.00331;ESCO.0722.00331.0014;ESCO.0722.00331.0014i_01426;122610;123149;539
ESCO.0722.00331;ESCO.0722.00331.0090;ESCO.0722.00331.0090i_04146;2206;2943;737
ESCO.0722.00331;ESCO.0722.00331.0141;ESCO.0722.00331.0141b_04210;2;226;224
ESCO.0722.00331;ESCO.0722.00331.0033;ESCO.0722.00331.0033i_02753;33816;35048;1232
ESCO.0722.00331;ESCO.0722.00331.0038;ESCO.0722.00331.0038i_02945;19457;19807;350
ESCO.0722.00331;ESCO.0722.00331.0061;ESCO.0722.00331.0061i_03745;23928;24440;512
ESCO.0722.00331;ESCO.0722.00331.0069;ESCO.0722.00331.0069i_03937;7779;8324;545
ESCO.0722.00331;ESCO.0722.00331.0159;ESCO.0722.00331.0159b_04225;1;204;203
ESCO.0722.00331;ESCO.0722.00331.0014;ESCO.0722.00331.0014i_01410;109416;110339;923
ESCO.0722.00331;ESCO.0722.00331.0016;ESCO.0722.00331.0016i_01698;124880;125839;959
ESCO.0722.00331;ESCO.0722.00331.0038;ESCO.0722.00331.0038i_02946;19849;20130;281
ESCO.0722.00331;ESCO.0722.00331.0095;ESCO.0722.00331.0095b_04162;1365;1970;605
ESCO.0722.00331;ESCO.0722.00331.0160;ESCO.0722.00331.0160b_04226;1;210;209
ESCO.0722.00331;ESCO.0722.00331.0014;ESCO.0722.00331.0014i_01411;110502;111464;962
ESCO.0722.00331;ESCO.0722.00331.0016;ESCO.0722.00331.0016b_01699;125874;127013;1139
ESCO.0722.00331;ESCO.0722.00331.0017;ESCO.0722.00331.0017i_01731;39043;39666;623
ESCO.0722.00331;ESCO.0722.00331.0019;ESCO.0722.00331.0019b_01923;143;631;488
ESCO.0722.00331;ESCO.0722.00331.0027;ESCO.0722.00331.0027i_02467;63147;63284;137
ESCO.0722.00331;ESCO.0722.00331.0038;ESCO.0722.00331.0038i_02947;20185;20559;374
ESCO.0722.00331;ESCO.0722.00331.0061;ESCO.0722.00331.0061i_03747;25308;25469;161
ESCO.0722.00331;ESCO.0722.00331.0161;ESCO.0722.00331.0161b_04227;1;120;119
ESCO.0722.00331;ESCO.0722.00331.0007;ESCO.0722.00331.0007i_00727;2597;3508;911
ESCO.0722.00331;ESCO.0722.00331.0016;ESCO.0722.00331.0016i_01687;112383;113342;959
ESCO.0722.00331;ESCO.0722.00331.0038;ESCO.0722.00331.0038i_02967;40425;40709;284
ESCO.0722.00331;ESCO.0722.00331.0051;ESCO.0722.00331.0051i_03415;11257;12273;1016
ESCO.0722.00331;ESCO.0722.00331.0038;ESCO.0722.00331.0038i_02968;40699;41019;320
ESCO.0722.00331;ESCO.0722.00331.0149;ESCO.0722.00331.0149b_04216;48;158;110
ESCO.0722.00331;ESCO.0722.00331.0002;ESCO.0722.00331.0002b_00304;294817;295539;722
ESCO.0722.00331;ESCO.0722.00331.0006;ESCO.0722.00331.0006b_00720;1;72;71
ESCO.0722.00331;ESCO.0722.00331.0014;ESCO.0722.00331.0014i_01424;121599;122036;437
ESCO.0722.00331;ESCO.0722.00331.0021;ESCO.0722.00331.0021i_02224;89345;89620;275
ESCO.0722.00331;ESCO.0722.00331.0055;ESCO.0722.00331.0055i_03536;2021;2281;260
ESCO.0722.00331;ESCO.0722.00331.0058;ESCO.0722.00331.0058b_03632;55;675;620
ESCO.0722.00331;ESCO.0722.00331.0074;ESCO.0722.00331.0074i_04016;9289;10113;824
ESCO.0722.00331;ESCO.0722.00331.0137;ESCO.0722.00331.0137b_04208;22;228;206
ESCO.0722.00331;ESCO.0722.00331.0003;ESCO.0722.00331.0003i_00394;87832;88089;257
ESCO.0722.00331;ESCO.0722.00331.0009;ESCO.0722.00331.0009i_00842;23749;24459;710
ESCO.0722.00331;ESCO.0722.00331.0014;ESCO.0722.00331.0014i_01418;116641;117447;806
ESCO.0722.00331;ESCO.0722.00331.0030;ESCO.0722.00331.0030i_02698;60768;61247;479
ESCO.0722.00331;ESCO.0722.00331.0039;ESCO.0722.00331.0039i_02986;1689;3269;1580
ESCO.0722.00331;ESCO.0722.00331.0051;ESCO.0722.00331.0051i_03402;366;2426;2060
ESCO.0722.00331;ESCO.0722.00331.0098;ESCO.0722.00331.0098b_04170;1284;1721;437
ESCO.0722.00331;ESCO.0722.00331.0126;ESCO.0722.00331.0126b_04202;1;258;257
ESCO.0722.00331;ESCO.0722.00331.0167;ESCO.0722.00331.0167b_04234;3;206;203
ESCO.0722.00331;ESCO.0722.00331.0009;ESCO.0722.00331.0009i_00843;24474;25385;911
ESCO.0722.00331;ESCO.0722.00331.0014;ESCO.0722.00331.0014i_01323;18967;19587;620
ESCO.0722.00331;ESCO.0722.00331.0018;ESCO.0722.00331.0018i_01867;58160;58762;602
ESCO.0722.00331;ESCO.0722.00331.0030;ESCO.0722.00331.0030i_02699;61244;61750;506
ESCO.0722.00331;ESCO.0722.00331.0039;ESCO.0722.00331.0039i_02987;3322;4272;950
ESCO.0722.00331;ESCO.0722.00331.0054;ESCO.0722.00331.0054b_03531;25830;26321;491
ESCO.0722.00331;ESCO.0722.00331.0099;ESCO.0722.00331.0099b_04171;2;142;140
ESCO.0722.00331;ESCO.0722.00331.0170;ESCO.0722.00331.0170b_04235;42;179;137
ESCO.0722.00331;ESCO.0722.00331.0014;ESCO.0722.00331.0014i_01324;19652;20857;1205
ESCO.0722.00331;ESCO.0722.00331.0018;ESCO.0722.00331.0018i_01868;58762;59754;992
ESCO.0722.00331;ESCO.0722.00331.0039;ESCO.0722.00331.0039i_02988;4346;5329;983
ESCO.0722.00331;ESCO.0722.00331.0078;ESCO.0722.00331.0078b_04076;9865;9945;80
ESCO.0722.00331;ESCO.0722.00331.0099;ESCO.0722.00331.0099b_04172;176;1600;1424
ESCO.0722.00331;ESCO.0722.00331.0132;ESCO.0722.00331.0132b_04204;2;235;233
ESCO.0722.00331;ESCO.0722.00331.0173;ESCO.0722.00331.0173b_04236;2;169;167
ESCO.0722.00331;ESCO.0722.00331.0061;ESCO.0722.00331.0061b_03751;29625;29879;254
ESCO.0722.00331;ESCO.0722.00331.0065;ESCO.0722.00331.0065i_03847;5548;6570;1022
ESCO.0722.00331;ESCO.0722.00331.0164;ESCO.0722.00331.0164b_04231;2;157;155
ESCO.0722.00331;ESCO.0722.00331.0002;ESCO.0722.00331.0002i_00136;109478;109780;302
ESCO.0722.00331;ESCO.0722.00331.0024;ESCO.0722.00331.0024i_02344;25508;26131;623
ESCO.0722.00331;ESCO.0722.00331.0029;ESCO.0722.00331.0029i_02600;39221;39652;431
ESCO.0722.00331;ESCO.0722.00331.0030;ESCO.0722.00331.0030i_02696;59394;60218;824
ESCO.0722.00331;ESCO.0722.00331.0039;ESCO.0722.00331.0039b_02984;32;493;461
ESCO.0722.00331;ESCO.0722.00331.0081;ESCO.0722.00331.0081b_04104;7773;8054;281
ESCO.0722.00331;ESCO.0722.00331.0122;ESCO.0722.00331.0122b_04200;2;271;269
ESCO.0722.00331;ESCO.0722.00331.0165;ESCO.0722.00331.0165b_04232;3;206;203
ESCO.0722.00331;ESCO.0722.00331.0024;ESCO.0722.00331.0024i_02345;26128;26421;293
ESCO.0722.00331;ESCO.0722.00331.0030;ESCO.0722.00331.0030i_02697;60220;60771;551
ESCO.0722.00331;ESCO.0722.00331.0035;ESCO.0722.00331.0035b_02825;2;628;626
ESCO.0722.00331;ESCO.0722.00331.0039;ESCO.0722.00331.0039i_02985;626;1624;998
ESCO.0722.00331;ESCO.0722.00331.0082;ESCO.0722.00331.0082b_04105;52;309;257
ESCO.0722.00331;ESCO.0722.00331.0086;ESCO.0722.00331.0086b_04137;2737;5388;2651
ESCO.0722.00331;ESCO.0722.00331.0166;ESCO.0722.00331.0166b_04233;3;206;203
ESCO.0722.00331;ESCO.0722.00331.0013;ESCO.0722.00331.0013i_01201;42461;42946;485
ESCO.0722.00331;ESCO.0722.00331.0055;ESCO.0722.00331.0055i_03537;2348;2914;566
ESCO.0722.00331;ESCO.0722.00331.0090;ESCO.0722.00331.0090i_04145;1863;2258;395
ESCO.0722.00331;ESCO.0722.00331.0140;ESCO.0722.00331.0140b_04209;1;102;101
ESCO.0722.00331;ESCO.0722.00331.0043;ESCO.0722.00331.0043b_03164;73;270;197
ESCO.0722.00331;ESCO.0722.00331.0069;ESCO.0722.00331.0069i_03932;3085;3906;821
ESCO.0722.00331;ESCO.0722.00331.0071;ESCO.0722.00331.0071i_03964;1873;2538;665
ESCO.0722.00331;ESCO.0722.00331.0153;ESCO.0722.00331.0153b_04220;2;217;215
ESCO.0722.00331;ESCO.0722.00331.0003;ESCO.0722.00331.0003i_00413;107568;108422;854
ESCO.0722.00331;ESCO.0722.00331.0003;ESCO.0722.00331.0003i_00541;234014;234664;650
ESCO.0722.00331;ESCO.0722.00331.0069;ESCO.0722.00331.0069i_03933;3906;4652;746
ESCO.0722.00331;ESCO.0722.00331.0071;ESCO.0722.00331.0071i_03965;2642;3073;431
ESCO.0722.00331;ESCO.0722.00331.0109;ESCO.0722.00331.0109b_04189;435;653;218
ESCO.0722.00331;ESCO.0722.00331.0014;ESCO.0722.00331.0014i_01401;103585;103917;332
ESCO.0722.00331;ESCO.0722.00331.0018;ESCO.0722.00331.0018b_01817;33;527;494
ESCO.0722.00331;ESCO.0722.00331.0069;ESCO.0722.00331.0069b_03929;47;814;767
ESCO.0722.00331;ESCO.0722.00331.0072;ESCO.0722.00331.0072b_03993;14396;16114;1718
ESCO.0722.00331;ESCO.0722.00331.0083;ESCO.0722.00331.0083b_04121;6621;7385;764
ESCO.0722.00331;ESCO.0722.00331.0150;ESCO.0722.00331.0150b_04217;3;185;182
ESCO.0722.00331;ESCO.0722.00331.0069;ESCO.0722.00331.0069i_03930;804;1916;1112
ESCO.0722.00331;ESCO.0722.00331.0071;ESCO.0722.00331.0071b_03962;1488;1679;191
ESCO.0722.00331;ESCO.0722.00331.0092;ESCO.0722.00331.0092b_04154;2;2887;2885
ESCO.0722.00331;ESCO.0722.00331.0151;ESCO.0722.00331.0151b_04218;3;221;218
ESCO.0722.00331;ESCO.0722.00331.0037;ESCO.0722.00331.0037i_02907;32307;32606;299
ESCO.0722.00331;ESCO.0722.00331.0069;ESCO.0722.00331.0069i_03931;1913;3088;1175
ESCO.0722.00331;ESCO.0722.00331.0071;ESCO.0722.00331.0071i_03963;1749;1913;164
ESCO.0722.00331;ESCO.0722.00331.0152;ESCO.0722.00331.0152b_04219;3;218;215
ESCO.0722.00331;ESCO.0722.00331.0003;ESCO.0722.00331.0003i_00420;115466;116476;1010
ESCO.0722.00331;ESCO.0722.00331.0038;ESCO.0722.00331.0038i_02948;20920;21456;536
ESCO.0722.00331;ESCO.0722.00331.0061;ESCO.0722.00331.0061i_03748;25619;26758;1139
ESCO.0722.00331;ESCO.0722.00331.0085;ESCO.0722.00331.0085b_04132;4885;5481;596
ESCO.0722.00331;ESCO.0722.00331.0161;ESCO.0722.00331.0161b_04228;139;210;71
ESCO.0722.00331;ESCO.0722.00331.0011;ESCO.0722.00331.0011i_01061;48622;49341;719
ESCO.0722.00331;ESCO.0722.00331.0162;ESCO.0722.00331.0162b_04229;18;209;191
ESCO.0722.00331;ESCO.0722.00331.0017;ESCO.0722.00331.0017i_01702;2756;2929;173
ESCO.0722.00331;ESCO.0722.00331.0065;ESCO.0722.00331.0065i_03846;4475;5524;1049
ESCO.0722.00331;ESCO.0722.00331.0119;ESCO.0722.00331.0119b_04198;3;332;329
ESCO.0722.00331;ESCO.0722.00331.0163;ESCO.0722.00331.0163b_04230;1;207;206
ESCO.0722.00331;ESCO.0722.00331.0002;ESCO.0722.00331.0002i_00303;293447;294799;1352
ESCO.0722.00331;ESCO.0722.00331.0003;ESCO.0722.00331.0003i_00527;227676;227813;137
ESCO.0722.00331;ESCO.0722.00331.0005;ESCO.0722.00331.0005b_00719;45020;45370;350
ESCO.0722.00331;ESCO.0722.00331.0014;ESCO.0722.00331.0014i_01423;119975;121597;1622
ESCO.0722.00331;ESCO.0722.00331.0021;ESCO.0722.00331.0021i_02223;88521;89363;842
ESCO.0722.00331;ESCO.0722.00331.0028;ESCO.0722.00331.0028b_02479;51;482;431
ESCO.0722.00331;ESCO.0722.00331.0044;ESCO.0722.00331.0044i_03215;11393;11719;326
ESCO.0722.00331;ESCO.0722.00331.0074;ESCO.0722.00331.0074i_04015;9097;9273;176
ESCO.0722.00331;ESCO.0722.00331.0136;ESCO.0722.00331.0136b_04207;91;231;140
ESCO.0722.00331;ESCO.0722.00331.0186;ESCO.0722.00331.0186b_04239;2;112;110
ESCO.0722.00331;ESCO.0722.00331.0014;ESCO.0722.00331.0014i_01427;123180;123455;275
ESCO.0722.00331;ESCO.0722.00331.0144;ESCO.0722.00331.0144b_04211;149;223;74
ESCO.0722.00331;ESCO.0722.00331.0196;ESCO.0722.00331.0196b_04243;3;104;101
ESCO.0722.00331;ESCO.0722.00331.0013;ESCO.0722.00331.0013i_01204;44474;44848;374
ESCO.0722.00331;ESCO.0722.00331.0014;ESCO.0722.00331.0014i_01428;123452;123820;368
ESCO.0722.00331;ESCO.0722.00331.0016;ESCO.0722.00331.0016b_01588;39;590;551
ESCO.0722.00331;ESCO.0722.00331.0024;ESCO.0722.00331.0024b_02324;27;773;746
ESCO.0722.00331;ESCO.0722.00331.0030;ESCO.0722.00331.0030i_02708;73195;73308;113
ESCO.0722.00331;ESCO.0722.00331.0039;ESCO.0722.00331.0039b_03028;53997;54188;191
ESCO.0722.00331;ESCO.0722.00331.0145;ESCO.0722.00331.0145b_04212;3;224;221
ESCO.0722.00331;ESCO.0722.00331.0197;ESCO.0722.00331.0197b_04244;1;105;104
ESCO.0722.00331;ESCO.0722.00331.0013;ESCO.0722.00331.0013i_01301;151807;152091;284
ESCO.0722.00331;ESCO.0722.00331.0030;ESCO.0722.00331.0030b_02709;73580;74014;434
ESCO.0722.00331;ESCO.0722.00331.0040;ESCO.0722.00331.0040b_03029;26;433;407
ESCO.0722.00331;ESCO.0722.00331.0043;ESCO.0722.00331.0043i_03189;28883;29731;848
ESCO.0722.00331;ESCO.0722.00331.0046;ESCO.0722.00331.0046b_03285;12417;12803;386
ESCO.0722.00331;ESCO.0722.00331.0083;ESCO.0722.00331.0083b_04117;154;3408;3254
ESCO.0722.00331;ESCO.0722.00331.0091;ESCO.0722.00331.0091b_04149;215;766;551
ESCO.0722.00331;ESCO.0722.00331.0147;ESCO.0722.00331.0147b_04213;2;61;59
ESCO.0722.00331;ESCO.0722.00331.0007;ESCO.0722.00331.0007i_00726;1934;2467;533
ESCO.0722.00331;ESCO.0722.00331.0013;ESCO.0722.00331.0013i_01206;45867;46052;185
ESCO.0722.00331;ESCO.0722.00331.0013;ESCO.0722.00331.0013i_01238;82581;83066;485
ESCO.0722.00331;ESCO.0722.00331.0091;ESCO.0722.00331.0091i_04150;730;1983;1253
ESCO.0722.00331;ESCO.0722.00331.0104;ESCO.0722.00331.0104b_04182;566;1060;494
ESCO.0722.00331;ESCO.0722.00331.0147;ESCO.0722.00331.0147b_04214;158;223;65
ESCO.0722.00331;ESCO.0722.00331.0003;ESCO.0722.00331.0003i_00414;108422;108721;299
ESCO.0722.00331;ESCO.0722.00331.0014;ESCO.0722.00331.0014i_01406;106385;107830;1445
ESCO.0722.00331;ESCO.0722.00331.0021;ESCO.0722.00331.0021i_02206;72509;72823;314
ESCO.0722.00331;ESCO.0722.00331.0069;ESCO.0722.00331.0069i_03934;4649;5227;578
ESCO.0722.00331;ESCO.0722.00331.0071;ESCO.0722.00331.0071i_03966;3120;3365;245
ESCO.0722.00331;ESCO.0722.00331.0080;ESCO.0722.00331.0080i_04094;6009;6614;605
ESCO.0722.00331;ESCO.0722.00331.0156;ESCO.0722.00331.0156b_04222;2;214;212
ESCO.0722.00331;ESCO.0722.00331.0005;ESCO.0722.00331.0005i_00703;26115;26534;419
ESCO.0722.00331;ESCO.0722.00331.0021;ESCO.0722.00331.0021i_02207;72839;73261;422
ESCO.0722.00331;ESCO.0722.00331.0069;ESCO.0722.00331.0069i_03935;5229;6341;1112
ESCO.0722.00331;ESCO.0722.00331.0113;ESCO.0722.00331.0113b_04191;3;407;404
ESCO.0722.00331;ESCO.0722.00331.0157;ESCO.0722.00331.0157b_04223;35;214;179
ESCO.0722.00331;ESCO.0722.00331.0003;ESCO.0722.00331.0003b_00544;235932;236081;149
ESCO.0722.00331;ESCO.0722.00331.0005;ESCO.0722.00331.0005i_00704;26594;27331;737
ESCO.0722.00331;ESCO.0722.00331.0038;ESCO.0722.00331.0038i_02944;18369;19502;1133
ESCO.0722.00331;ESCO.0722.00331.0061;ESCO.0722.00331.0061i_03744;23463;23759;296
ESCO.0722.00331;ESCO.0722.00331.0069;ESCO.0722.00331.0069i_03936;6351;7775;1424
ESCO.0722.00331;ESCO.0722.00331.0080;ESCO.0722.00331.0080b_04096;8288;8515;227
ESCO.0722.00331;ESCO.0722.00331.0158;ESCO.0722.00331.0158b_04224;2;211;209
ESCO.0722.00331;ESCO.0722.00331.0003;ESCO.0722.00331.0003i_00525;226362;226625;263
ESCO.0722.00331;ESCO.0722.00331.0007;ESCO.0722.00331.0007i_00781;63750;64136;386
ESCO.0722.00331;ESCO.0722.00331.0013;ESCO.0722.00331.0013b_01165;51;554;503
ESCO.0722.00331;ESCO.0722.00331.0014;ESCO.0722.00331.0014i_01325;21159;22097;938
ESCO.0722.00331;ESCO.0722.00331.0039;ESCO.0722.00331.0039i_02989;5333;6832;1499
ESCO.0722.00331;ESCO.0722.00331.0044;ESCO.0722.00331.0044i_03245;44398;45270;872
ESCO.0722.00331;ESCO.0722.00331.0071;ESCO.0722.00331.0071b_03981;17246;17506;260
ESCO.0722.00331;ESCO.0722.00331.0100;ESCO.0722.00331.0100b_04173;33;872;839
ESCO.0722.00331;ESCO.0722.00331.0003;ESCO.0722.00331.0003i_00526;226667;227641;974
ESCO.0722.00331;ESCO.0722.00331.0013;ESCO.0722.00331.0013i_01198;36784;37854;1070
ESCO.0722.00331;ESCO.0722.00331.0014;ESCO.0722.00331.0014i_01326;22496;22657;161
ESCO.0722.00331;ESCO.0722.00331.0029;ESCO.0722.00331.0029b_02638;74420;74965;545
ESCO.0722.00331;ESCO.0722.00331.0044;ESCO.0722.00331.0044i_03214;10179;11396;1217
ESCO.0722.00331;ESCO.0722.00331.0100;ESCO.0722.00331.0100b_04174;869;1390;521
ESCO.0722.00331;ESCO.0722.00331.0134;ESCO.0722.00331.0134b_04206;3;233;230
ESCO.0722.00331;ESCO.0722.00331.0183;ESCO.0722.00331.0183b_04238;1;138;137
ESCO.0722.00343;ESCO.0722.00343.0007;ESCO.0722.00343.0007i_00924;118563;119621;1058
ESCO.0722.00343;ESCO.0722.00343.0038;ESCO.0722.00343.0038i_03516;8167;8394;227
ESCO.0722.00343;ESCO.0722.00343.0073;ESCO.0722.00343.0073i_04540;3420;3812;392
ESCO.0722.00343;ESCO.0722.00343.0093;ESCO.0722.00343.0093i_04732;2877;4421;1544
ESCO.0722.00343;ESCO.0722.00343.0316;ESCO.0722.00343.0316b_05084;1;105;104
ESCO.0722.00343;ESCO.0722.00343.0359;ESCO.0722.00343.0359b_05116;2;205;203
ESCO.0722.00343;ESCO.0722.00343.0014;ESCO.0722.00343.0014b_01803;34;351;317
ESCO.0722.00343;ESCO.0722.00343.0086;ESCO.0722.00343.0086b_04683;1;996;995
ESCO.0722.00343;ESCO.0722.00343.0132;ESCO.0722.00343.0132b_04875;443;970;527
ESCO.0722.00343;ESCO.0722.00343.0191;ESCO.0722.00343.0191b_04971;302;448;146
ESCO.0722.00343;ESCO.0722.00343.0295;ESCO.0722.00343.0295b_05067;1;231;230
ESCO.0722.00343;ESCO.0722.00343.0337;ESCO.0722.00343.0337b_05099;76;210;134
ESCO.0722.00343;ESCO.0722.00343.0381;ESCO.0722.00343.0381b_05131;63;134;71
ESCO.0722.00343;ESCO.0722.00343.0066;ESCO.0722.00343.0066i_04428;14342;15232;890
ESCO.0722.00343;ESCO.0722.00343.0256;ESCO.0722.00343.0256b_05036;2;265;263
ESCO.0722.00343;ESCO.0722.00343.0296;ESCO.0722.00343.0296b_05068;1;231;230
ESCO.0722.00343;ESCO.0722.00343.0339;ESCO.0722.00343.0339b_05100;3;209;206
ESCO.0722.00343;ESCO.0722.00343.0054;ESCO.0722.00343.0054i_04109;10076;10396;320
ESCO.0722.00343;ESCO.0722.00343.0340;ESCO.0722.00343.0340b_05101;1;210;209
ESCO.0722.00343;ESCO.0722.00343.0038;ESCO.0722.00343.0038i_03521;9896;10288;392
ESCO.0722.00343;ESCO.0722.00343.0183;ESCO.0722.00343.0183b_04961;1;492;491
ESCO.0722.00343;ESCO.0722.00343.0246;ESCO.0722.00343.0246b_05025;43;276;233
ESCO.0722.00343;ESCO.0722.00343.0284;ESCO.0722.00343.0284b_05057;2;238;236
ESCO.0722.00343;ESCO.0722.00343.0324;ESCO.0722.00343.0324b_05089;2;217;215
ESCO.0722.00343;ESCO.0722.00343.0365;ESCO.0722.00343.0365b_05121;114;179;65
ESCO.0722.00343;ESCO.0722.00343.0038;ESCO.0722.00343.0038i_03522;10349;10537;188
ESCO.0722.00343;ESCO.0722.00343.0103;ESCO.0722.00343.0103b_04770;2;142;140
ESCO.0722.00343;ESCO.0722.00343.0285;ESCO.0722.00343.0285b_05058;167;238;71
ESCO.0722.00343;ESCO.0722.00343.0325;ESCO.0722.00343.0325b_05090;1;219;218
ESCO.0722.00343;ESCO.0722.00343.0366;ESCO.0722.00343.0366b_05122;1;177;176
ESCO.0722.00343;ESCO.0722.00343.0007;ESCO.0722.00343.0007i_00922;117791;118096;305
ESCO.0722.00343;ESCO.0722.00343.0013;ESCO.0722.00343.0013i_01658;37333;38298;965
ESCO.0722.00343;ESCO.0722.00343.0013;ESCO.0722.00343.0013i_01690;60572;62029;1457
ESCO.0722.00343;ESCO.0722.00343.0073;ESCO.0722.00343.0073i_04538;2669;3130;461
ESCO.0722.00343;ESCO.0722.00343.0093;ESCO.0722.00343.0093i_04730;1136;2362;1226
ESCO.0722.00343;ESCO.0722.00343.0178;ESCO.0722.00343.0178b_04954;1;525;524
ESCO.0722.00343;ESCO.0722.00343.0313;ESCO.0722.00343.0313b_05082;2;223;221
ESCO.0722.00343;ESCO.0722.00343.0420;ESCO.0722.00343.0420b_05146;2;70;68
ESCO.0722.00343;ESCO.0722.00343.0115;ESCO.0722.00343.0115b_04820;28;984;956
ESCO.0722.00343;ESCO.0722.00343.0136;ESCO.0722.00343.0136b_04884;3;1331;1328
ESCO.0722.00343;ESCO.0722.00343.0173;ESCO.0722.00343.0173b_04948;3;404;401
ESCO.0722.00343;ESCO.0722.00343.0304;ESCO.0722.00343.0304b_05076;3;227;224
ESCO.0722.00343;ESCO.0722.00343.0350;ESCO.0722.00343.0350b_05108;2;208;206
ESCO.0722.00343;ESCO.0722.00343.0031;ESCO.0722.00343.0031i_03125;82076;82186;110
ESCO.0722.00343;ESCO.0722.00343.0058;ESCO.0722.00343.0058b_04245;29389;29886;497
ESCO.0722.00343;ESCO.0722.00343.0115;ESCO.0722.00343.0115i_04821;1075;2178;1103
ESCO.0722.00343;ESCO.0722.00343.0351;ESCO.0722.00343.0351b_05109;3;206;203
ESCO.0722.00343;ESCO.0722.00343.0403;ESCO.0722.00343.0403b_05141;3;104;101
ESCO.0722.00343;ESCO.0722.00343.0066;ESCO.0722.00343.0066i_04433;16914;17234;320
ESCO.0722.00343;ESCO.0722.00343.0195;ESCO.0722.00343.0195b_04977;359;442;83
ESCO.0722.00343;ESCO.0722.00343.0347;ESCO.0722.00343.0347b_05105;46;207;161
ESCO.0722.00343;ESCO.0722.00343.0100;ESCO.0722.00343.0100b_04754;2;904;902
ESCO.0722.00343;ESCO.0722.00343.0264;ESCO.0722.00343.0264b_05042;2;259;257
ESCO.0722.00343;ESCO.0722.00343.0348;ESCO.0722.00343.0348b_05106;1;207;206
ESCO.0722.00343;ESCO.0722.00343.0062;ESCO.0722.00343.0062b_04339;3;74;71
ESCO.0722.00343;ESCO.0722.00343.0154;ESCO.0722.00343.0154b_04915;3;974;971
ESCO.0722.00343;ESCO.0722.00343.0265;ESCO.0722.00343.0265b_05043;1;87;86
ESCO.0722.00343;ESCO.0722.00343.0303;ESCO.0722.00343.0303b_05075;3;227;224
ESCO.0722.00343;ESCO.0722.00343.0349;ESCO.0722.00343.0349b_05107;3;146;143
ESCO.0722.00343;ESCO.0722.00343.0013;ESCO.0722.00343.0013i_01659;38309;38710;401
ESCO.0722.00343;ESCO.0722.00343.0038;ESCO.0722.00343.0038i_03515;7995;8237;242
ESCO.0722.00343;ESCO.0722.00343.0073;ESCO.0722.00343.0073i_04539;3127;3423;296
ESCO.0722.00343;ESCO.0722.00343.0093;ESCO.0722.00343.0093i_04731;2385;2501;116
ESCO.0722.00343;ESCO.0722.00343.0314;ESCO.0722.00343.0314b_05083;2;196;194
ESCO.0722.00343;ESCO.0722.00343.0358;ESCO.0722.00343.0358b_05115;9;206;197
ESCO.0722.00343;ESCO.0722.00343.0421;ESCO.0722.00343.0421b_05147;3;68;65
ESCO.0722.00343;ESCO.0722.00343.0111;ESCO.0722.00343.0111b_04806;3;113;110
ESCO.0722.00343;ESCO.0722.00343.0331;ESCO.0722.00343.0331b_05094;1;213;212
ESCO.0722.00343;ESCO.0722.00343.0073;ESCO.0722.00343.0073i_04551;9670;9873;203
ESCO.0722.00343;ESCO.0722.00343.0119;ESCO.0722.00343.0119i_04839;612;1064;452
ESCO.0722.00343;ESCO.0722.00343.0189;ESCO.0722.00343.0189b_04967;1;483;482
ESCO.0722.00343;ESCO.0722.00343.0291;ESCO.0722.00343.0291b_05063;2;232;230
ESCO.0722.00343;ESCO.0722.00343.0332;ESCO.0722.00343.0332b_05095;3;212;209
ESCO.0722.00343;ESCO.0722.00343.0081;ESCO.0722.00343.0081b_04643;2;136;134
ESCO.0722.00343;ESCO.0722.00343.0110;ESCO.0722.00343.0110b_04803;3;161;158
ESCO.0722.00343;ESCO.0722.00343.0248;ESCO.0722.00343.0248b_05027;2;274;272
ESCO.0722.00343;ESCO.0722.00343.0326;ESCO.0722.00343.0326b_05091;3;218;215
ESCO.0722.00343;ESCO.0722.00343.0038;ESCO.0722.00343.0038i_03524;11403;11774;371
ESCO.0722.00343;ESCO.0722.00343.0127;ESCO.0722.00343.0127b_04868;1573;1851;278
ESCO.0722.00343;ESCO.0722.00343.0186;ESCO.0722.00343.0186b_04964;1;483;482
ESCO.0722.00343;ESCO.0722.00343.0214;ESCO.0722.00343.0214b_04996;3;356;353
ESCO.0722.00343;ESCO.0722.00343.0328;ESCO.0722.00343.0328b_05092;2;214;212
ESCO.0722.00343;ESCO.0722.00343.0018;ESCO.0722.00343.0018i_02085;70008;70397;389
ESCO.0722.00343;ESCO.0722.00343.0038;ESCO.0722.00343.0038i_03525;11806;12048;242
ESCO.0722.00343;ESCO.0722.00343.0073;ESCO.0722.00343.0073i_04549;8620;9474;854
ESCO.0722.00343;ESCO.0722.00343.0110;ESCO.0722.00343.0110b_04805;1008;1850;842
ESCO.0722.00343;ESCO.0722.00343.0187;ESCO.0722.00343.0187b_04965;1;483;482
ESCO.0722.00343;ESCO.0722.00343.0289;ESCO.0722.00343.0289b_05061;1;234;233
ESCO.0722.00343;ESCO.0722.00343.0329;ESCO.0722.00343.0329b_05093;1;216;215
ESCO.0722.00343;ESCO.0722.00343.0013;ESCO.0722.00343.0013i_01646;30317;30838;521
ESCO.0722.00343;ESCO.0722.00343.0054;ESCO.0722.00343.0054i_04110;10264;10905;641
ESCO.0722.00343;ESCO.0722.00343.0298;ESCO.0722.00343.0298b_05070;3;230;227
ESCO.0722.00343;ESCO.0722.00343.0344;ESCO.0722.00343.0344b_05102;1;210;209
ESCO.0722.00343;ESCO.0722.00343.0038;ESCO.0722.00343.0038i_03503;564;821;257
ESCO.0722.00343;ESCO.0722.00343.0054;ESCO.0722.00343.0054i_04111;11868;12035;167
ESCO.0722.00343;ESCO.0722.00343.0091;ESCO.0722.00343.0091b_04719;3272;5476;2204
ESCO.0722.00343;ESCO.0722.00343.0152;ESCO.0722.00343.0152b_04911;2;148;146
ESCO.0722.00343;ESCO.0722.00343.0195;ESCO.0722.00343.0195b_04975;3;74;71
ESCO.0722.00343;ESCO.0722.00343.0226;ESCO.0722.00343.0226b_05007;2;325;323
ESCO.0722.00343;ESCO.0722.00343.0299;ESCO.0722.00343.0299b_05071;1;129;128
ESCO.0722.00343;ESCO.0722.00343.0345;ESCO.0722.00343.0345b_05103;2;109;107
ESCO.0722.00343;ESCO.0722.00343.0299;ESCO.0722.00343.0299b_05072;141;230;89
ESCO.0722.00343;ESCO.0722.00343.0346;ESCO.0722.00343.0346b_05104;61;207;146
ESCO.0722.00343;ESCO.0722.00343.0093;ESCO.0722.00343.0093i_04729;432;1139;707
ESCO.0722.00343;ESCO.0722.00343.0125;ESCO.0722.00343.0125b_04857;1;1542;1541
ESCO.0722.00343;ESCO.0722.00343.0203;ESCO.0722.00343.0203b_04985;1;393;392
ESCO.0722.00343;ESCO.0722.00343.0270;ESCO.0722.00343.0270b_05049;2;253;251
ESCO.0722.00343;ESCO.0722.00343.0312;ESCO.0722.00343.0312b_05081;3;224;221
ESCO.0722.00343;ESCO.0722.00343.0355;ESCO.0722.00343.0355b_05113;71;205;134
ESCO.0722.00343;ESCO.0722.00343.0007;ESCO.0722.00343.0007i_00925;119627;121411;1784
ESCO.0722.00343;ESCO.0722.00343.0034;ESCO.0722.00343.0034b_03325;69279;69461;182
ESCO.0722.00343;ESCO.0722.00343.0044;ESCO.0722.00343.0044b_03869;44749;45024;275
ESCO.0722.00343;ESCO.0722.00343.0093;ESCO.0722.00343.0093i_04733;4587;4835;248
ESCO.0722.00343;ESCO.0722.00343.0317;ESCO.0722.00343.0317b_05085;2;220;218
ESCO.0722.00343;ESCO.0722.00343.0428;ESCO.0722.00343.0428b_05149;1;60;59
ESCO.0722.00343;ESCO.0722.00343.0007;ESCO.0722.00343.0007i_00926;121408;122973;1565
ESCO.0722.00343;ESCO.0722.00343.0031;ESCO.0722.00343.0031b_03038;37;675;638
ESCO.0722.00343;ESCO.0722.00343.0038;ESCO.0722.00343.0038i_03518;9018;9131;113
ESCO.0722.00343;ESCO.0722.00343.0007;ESCO.0722.00343.0007i_00927;122970;124643;1673
ESCO.0722.00343;ESCO.0722.00343.0013;ESCO.0722.00343.0013i_01663;40349;40927;578
ESCO.0722.00343;ESCO.0722.00343.0038;ESCO.0722.00343.0038i_03519;9135;9494;359
ESCO.0722.00343;ESCO.0722.00343.0209;ESCO.0722.00343.0209b_04991;2;364;362
ESCO.0722.00343;ESCO.0722.00343.0243;ESCO.0722.00343.0243b_05023;72;284;212
ESCO.0722.00343;ESCO.0722.00343.0319;ESCO.0722.00343.0319b_05087;1;135;134
ESCO.0722.00343;ESCO.0722.00343.0013;ESCO.0722.00343.0013i_01664;41028;41363;335
ESCO.0722.00343;ESCO.0722.00343.0038;ESCO.0722.00343.0038i_03520;9494;9709;215
ESCO.0722.00343;ESCO.0722.00343.0085;ESCO.0722.00343.0085b_04672;1;153;152
ESCO.0722.00343;ESCO.0722.00343.0323;ESCO.0722.00343.0323b_05088;2;220;218
ESCO.0722.00343;ESCO.0722.00343.0008;ESCO.0722.00343.0008i_01096;76761;77921;1160
ESCO.0722.00343;ESCO.0722.00343.0013;ESCO.0722.00343.0013i_01640;27175;27273;98
ESCO.0722.00343;ESCO.0722.00343.0111;ESCO.0722.00343.0111b_04808;1200;1457;257
ESCO.0722.00343;ESCO.0722.00343.0119;ESCO.0722.00343.0119i_04840;1243;1968;725
ESCO.0722.00343;ESCO.0722.00343.0148;ESCO.0722.00343.0148b_04904;2;562;560
ESCO.0722.00343;ESCO.0722.00343.0190;ESCO.0722.00343.0190b_04968;1;84;83
ESCO.0722.00343;ESCO.0722.00343.0292;ESCO.0722.00343.0292b_05064;166;234;68
ESCO.0722.00343;ESCO.0722.00343.0333;ESCO.0722.00343.0333b_05096;3;182;179
ESCO.0722.00343;ESCO.0722.00343.0008;ESCO.0722.00343.0008i_01097;77899;79491;1592
ESCO.0722.00343;ESCO.0722.00343.0148;ESCO.0722.00343.0148b_04905;789;1037;248
ESCO.0722.00343;ESCO.0722.00343.0167;ESCO.0722.00343.0167b_04937;1;183;182
ESCO.0722.00343;ESCO.0722.00343.0190;ESCO.0722.00343.0190b_04969;99;452;353
ESCO.0722.00343;ESCO.0722.00343.0219;ESCO.0722.00343.0219b_05001;3;338;335
ESCO.0722.00343;ESCO.0722.00343.0293;ESCO.0722.00343.0293b_05065;3;131;128
ESCO.0722.00343;ESCO.0722.00343.0334;ESCO.0722.00343.0334b_05097;1;213;212
ESCO.0722.00343;ESCO.0722.00343.0066;ESCO.0722.00343.0066i_04426;13433;13579;146
ESCO.0722.00343;ESCO.0722.00343.0068;ESCO.0722.00343.0068i_04458;305;685;380
ESCO.0722.00343;ESCO.0722.00343.0085;ESCO.0722.00343.0085b_04682;4519;6072;1553
ESCO.0722.00343;ESCO.0722.00343.0091;ESCO.0722.00343.0091b_04714;3;572;569
ESCO.0722.00343;ESCO.0722.00343.0220;ESCO.0722.00343.0220b_05002;3;338;335
ESCO.0722.00343;ESCO.0722.00343.0254;ESCO.0722.00343.0254b_05034;2;268;266
ESCO.0722.00343;ESCO.0722.00343.0294;ESCO.0722.00343.0294b_05066;3;233;230
ESCO.0722.00343;ESCO.0722.00343.0335;ESCO.0722.00343.0335b_05098;3;203;200
ESCO.0722.00343;ESCO.0722.00343.0380;ESCO.0722.00343.0380b_05130;2;133;131
ESCO.0722.00343;ESCO.0722.00343.0064;ESCO.0722.00343.0064b_04374;1;351;350
ESCO.0722.00343;ESCO.0722.00343.0073;ESCO.0722.00343.0073i_04534;482;1468;986
ESCO.0722.00343;ESCO.0722.00343.0123;ESCO.0722.00343.0123b_04854;1410;2150;740
ESCO.0722.00343;ESCO.0722.00343.0233;ESCO.0722.00343.0233b_05014;2;304;302
ESCO.0722.00343;ESCO.0722.00343.0308;ESCO.0722.00343.0308b_05078;2;226;224
ESCO.0722.00343;ESCO.0722.00343.0352;ESCO.0722.00343.0352b_05110;1;207;206
ESCO.0722.00343;ESCO.0722.00343.0073;ESCO.0722.00343.0073i_04535;1465;1830;365
ESCO.0722.00343;ESCO.0722.00343.0268;ESCO.0722.00343.0268b_05047;3;254;251
ESCO.0722.00343;ESCO.0722.00343.0309;ESCO.0722.00343.0309b_05079;3;212;209
ESCO.0722.00343;ESCO.0722.00343.0353;ESCO.0722.00343.0353b_05111;3;206;203
ESCO.0722.00343;ESCO.0722.00343.0405;ESCO.0722.00343.0405b_05143;2;103;101
ESCO.0722.00343;ESCO.0722.00343.0073;ESCO.0722.00343.0073i_04536;1832;2239;407
ESCO.0722.00343;ESCO.0722.00343.0089;ESCO.0722.00343.0089i_04696;287;460;173
ESCO.0722.00343;ESCO.0722.00343.0093;ESCO.0722.00343.0093b_04728;3;389;386
ESCO.0722.00343;ESCO.0722.00343.0235;ESCO.0722.00343.0235b_05016;2;295;293
ESCO.0722.00343;ESCO.0722.00343.0310;ESCO.0722.00343.0310b_05080;143;226;83
ESCO.0722.00343;ESCO.0722.00343.0354;ESCO.0722.00343.0354b_05112;3;206;203
ESCO.0722.00348;ESCO.0722.00348.0028;ESCO.0722.00348.0028i_03103;6175;7338;1163
ESCO.0722.00348;ESCO.0722.00348.0029;ESCO.0722.00348.0029i_03231;55349;56563;1214
ESCO.0722.00348;ESCO.0722.00348.0219;ESCO.0722.00348.0219b_04863;85;312;227
ESCO.0722.00348;ESCO.0722.00348.0292;ESCO.0722.00348.0292b_04927;2;160;158
ESCO.0722.00348;ESCO.0722.00348.0003;ESCO.0722.00348.0003b_00302;2;391;389
ESCO.0722.00348;ESCO.0722.00348.0063;ESCO.0722.00348.0063i_04302;9290;9397;107
ESCO.0722.00348;ESCO.0722.00348.0084;ESCO.0722.00348.0084i_04590;3439;4089;650
ESCO.0722.00348;ESCO.0722.00348.0175;ESCO.0722.00348.0175b_04814;458;538;80
ESCO.0722.00348;ESCO.0722.00348.0314;ESCO.0722.00348.0314b_04942;2;169;167
ESCO.0722.00348;ESCO.0722.00348.0362;ESCO.0722.00348.0362b_04974;1;99;98
ESCO.0722.00348;ESCO.0722.00348.0063;ESCO.0722.00348.0063i_04303;9617;10258;641
ESCO.0722.00348;ESCO.0722.00348.0084;ESCO.0722.00348.0084i_04591;4070;5173;1103
ESCO.0722.00348;ESCO.0722.00348.0273;ESCO.0722.00348.0273b_04911;3;176;173
ESCO.0722.00348;ESCO.0722.00348.0315;ESCO.0722.00348.0315b_04943;3;167;164
ESCO.0722.00348;ESCO.0722.00348.0364;ESCO.0722.00348.0364b_04975;3;95;92
ESCO.0722.00348;ESCO.0722.00348.0084;ESCO.0722.00348.0084i_04592;5283;5504;221
ESCO.0722.00348;ESCO.0722.00348.0097;ESCO.0722.00348.0097b_04656;321;638;317
ESCO.0722.00348;ESCO.0722.00348.0274;ESCO.0722.00348.0274b_04912;1;120;119
ESCO.0722.00348;ESCO.0722.00348.0316;ESCO.0722.00348.0316b_04944;1;165;164
ESCO.0722.00348;ESCO.0722.00348.0010;ESCO.0722.00348.0010i_01636;27015;30680;3665
ESCO.0722.00348;ESCO.0722.00348.0029;ESCO.0722.00348.0029i_03172;5648;7696;2048
ESCO.0722.00348;ESCO.0722.00348.0298;ESCO.0722.00348.0298b_04932;1;210;209
ESCO.0722.00348;ESCO.0722.00348.0029;ESCO.0722.00348.0029i_03173;7717;8724;1007
ESCO.0722.00348;ESCO.0722.00348.0145;ESCO.0722.00348.0145b_04773;3;962;959
ESCO.0722.00348;ESCO.0722.00348.0194;ESCO.0722.00348.0194b_04837;2;382;380
ESCO.0722.00348;ESCO.0722.00348.0299;ESCO.0722.00348.0299b_04933;2;208;206
ESCO.0722.00348;ESCO.0722.00348.0345;ESCO.0722.00348.0345b_04965;1;111;110
ESCO.0722.00348;ESCO.0722.00348.0059;ESCO.0722.00348.0059b_04221;23701;23835;134
ESCO.0722.00348;ESCO.0722.00348.0076;ESCO.0722.00348.0076b_04509;2;436;434
ESCO.0722.00348;ESCO.0722.00348.0086;ESCO.0722.00348.0086i_04605;1507;4863;3356
ESCO.0722.00348;ESCO.0722.00348.0253;ESCO.0722.00348.0253b_04893;2;238;236
ESCO.0722.00348;ESCO.0722.00348.0287;ESCO.0722.00348.0287b_04925;2;217;215
ESCO.0722.00348;ESCO.0722.00348.0391;ESCO.0722.00348.0391b_04989;2;67;65
ESCO.0722.00348;ESCO.0722.00348.0099;ESCO.0722.00348.0099b_04663;2964;3785;821
ESCO.0722.00348;ESCO.0722.00348.0281;ESCO.0722.00348.0281b_04919;3;86;83
ESCO.0722.00348;ESCO.0722.00348.0212;ESCO.0722.00348.0212b_04856;3;332;329
ESCO.0722.00348;ESCO.0722.00348.0281;ESCO.0722.00348.0281b_04920;77;220;143
ESCO.0722.00348;ESCO.0722.00348.0328;ESCO.0722.00348.0328b_04952;3;137;134
ESCO.0722.00348;ESCO.0722.00348.0383;ESCO.0722.00348.0383b_04984;1;75;74
ESCO.0722.00348;ESCO.0722.00348.0278;ESCO.0722.00348.0278b_04916;1;222;221
ESCO.0722.00348;ESCO.0722.00348.0377;ESCO.0722.00348.0377b_04980;3;80;77
ESCO.0722.00348;ESCO.0722.00348.0209;ESCO.0722.00348.0209b_04853;2;343;341
ESCO.0722.00348;ESCO.0722.00348.0279;ESCO.0722.00348.0279b_04917;2;220;218
ESCO.0722.00348;ESCO.0722.00348.0119;ESCO.0722.00348.0119b_04726;1;1899;1898
ESCO.0722.00348;ESCO.0722.00348.0280;ESCO.0722.00348.0280b_04918;42;221;179
ESCO.0722.00348;ESCO.0722.00348.0029;ESCO.0722.00348.0029i_03198;25533;26078;545
ESCO.0722.00348;ESCO.0722.00348.0064;ESCO.0722.00348.0064i_04318;2486;2890;404
ESCO.0722.00348;ESCO.0722.00348.0086;ESCO.0722.00348.0086i_04606;4860;6194;1334
ESCO.0722.00348;ESCO.0722.00348.0122;ESCO.0722.00348.0122b_04734;1550;1840;290
ESCO.0722.00348;ESCO.0722.00348.0163;ESCO.0722.00348.0163b_04798;1;438;437
ESCO.0722.00348;ESCO.0722.00348.0254;ESCO.0722.00348.0254b_04894;3;152;149
ESCO.0722.00348;ESCO.0722.00348.0289;ESCO.0722.00348.0289b_04926;1;216;215
ESCO.0722.00348;ESCO.0722.00348.0010;ESCO.0722.00348.0010i_01641;37734;38525;791
ESCO.0722.00348;ESCO.0722.00348.0029;ESCO.0722.00348.0029i_03209;32385;33341;956
ESCO.0722.00348;ESCO.0722.00348.0050;ESCO.0722.00348.0050i_03945;8070;8282;212
ESCO.0722.00348;ESCO.0722.00348.0064;ESCO.0722.00348.0064i_04329;13441;14040;599
ESCO.0722.00348;ESCO.0722.00348.0065;ESCO.0722.00348.0065b_04361;18349;19242;893
ESCO.0722.00348;ESCO.0722.00348.0084;ESCO.0722.00348.0084i_04585;1824;2042;218
ESCO.0722.00348;ESCO.0722.00348.0095;ESCO.0722.00348.0095b_04649;2;463;461
ESCO.0722.00348;ESCO.0722.00348.0351;ESCO.0722.00348.0351b_04969;3;110;107
ESCO.0722.00348;ESCO.0722.00348.0029;ESCO.0722.00348.0029i_03178;12063;12497;434
ESCO.0722.00348;ESCO.0722.00348.0029;ESCO.0722.00348.0029i_03210;33342;34124;782
ESCO.0722.00348;ESCO.0722.00348.0148;ESCO.0722.00348.0148b_04778;2;880;878
ESCO.0722.00348;ESCO.0722.00348.0173;ESCO.0722.00348.0173b_04810;254;550;296
ESCO.0722.00348;ESCO.0722.00348.0305;ESCO.0722.00348.0305b_04938;1;207;206
ESCO.0722.00348;ESCO.0722.00348.0170;ESCO.0722.00348.0170b_04806;271;576;305
ESCO.0722.00348;ESCO.0722.00348.0300;ESCO.0722.00348.0300b_04934;1;207;206
ESCO.0722.00348;ESCO.0722.00348.0064;ESCO.0722.00348.0064i_04327;12208;12687;479
ESCO.0722.00348;ESCO.0722.00348.0084;ESCO.0722.00348.0084i_04583;1247;1606;359
ESCO.0722.00348;ESCO.0722.00348.0301;ESCO.0722.00348.0301b_04935;2;208;206
ESCO.0722.00348;ESCO.0722.00348.0028;ESCO.0722.00348.0028i_03112;12900;14447;1547
ESCO.0722.00348;ESCO.0722.00348.0064;ESCO.0722.00348.0064i_04328;12693;13394;701
ESCO.0722.00348;ESCO.0722.00348.0302;ESCO.0722.00348.0302b_04936;3;203;200
ESCO.0722.00348;ESCO.0722.00348.0275;ESCO.0722.00348.0275b_04913;2;223;221
ESCO.0722.00348;ESCO.0722.00348.0368;ESCO.0722.00348.0368b_04977;2;91;89
ESCO.0722.00348;ESCO.0722.00348.0097;ESCO.0722.00348.0097b_04658;949;4293;3344
ESCO.0722.00348;ESCO.0722.00348.0241;ESCO.0722.00348.0241b_04882;1;108;107
ESCO.0722.00348;ESCO.0722.00348.0371;ESCO.0722.00348.0371b_04978;3;89;86
ESCO.0722.00348;ESCO.0722.00348.0155;ESCO.0722.00348.0155b_04787;3;791;788
ESCO.0722.00348;ESCO.0722.00348.0374;ESCO.0722.00348.0374b_04979;1;81;80
ESCO.0722.00348;ESCO.0722.00348.0185;ESCO.0722.00348.0185b_04828;3;431;428
ESCO.0722.00348;ESCO.0722.00348.0332;ESCO.0722.00348.0332b_04956;1;126;125
ESCO.0722.00348;ESCO.0722.00348.0029;ESCO.0722.00348.0029i_03232;56609;57220;611
ESCO.0722.00348;ESCO.0722.00348.0165;ESCO.0722.00348.0165b_04800;1;642;641
ESCO.0722.00348;ESCO.0722.00348.0293;ESCO.0722.00348.0293b_04928;2;214;212
ESCO.0722.00348;ESCO.0722.00348.0080;ESCO.0722.00348.0080i_04545;4993;5469;476
ESCO.0722.00348;ESCO.0722.00348.0142;ESCO.0722.00348.0142b_04769;1;522;521
ESCO.0722.00348;ESCO.0722.00348.0166;ESCO.0722.00348.0166b_04801;58;639;581
ESCO.0722.00348;ESCO.0722.00348.0190;ESCO.0722.00348.0190b_04833;3;410;407
ESCO.0722.00348;ESCO.0722.00348.0220;ESCO.0722.00348.0220b_04865;159;311;152
ESCO.0722.00348;ESCO.0722.00348.0294;ESCO.0722.00348.0294b_04929;2;214;212
ESCO.0722.00348;ESCO.0722.00348.0340;ESCO.0722.00348.0340b_04961;1;114;113
ESCO.0722.00348;ESCO.0722.00348.0006;ESCO.0722.00348.0006i_01058;57348;57599;251
ESCO.0722.00348;ESCO.0722.00348.0084;ESCO.0722.00348.0084b_04578;3;215;212
ESCO.0722.00348;ESCO.0722.00348.0142;ESCO.0722.00348.0142b_04770;503;1045;542
ESCO.0722.00348;ESCO.0722.00348.0295;ESCO.0722.00348.0295b_04930;136;210;74
ESCO.0722.00348;ESCO.0722.00348.0064;ESCO.0722.00348.0064i_04323;6574;6813;239
ESCO.0722.00348;ESCO.0722.00348.0259;ESCO.0722.00348.0259b_04899;1;234;233
ESCO.0722.00348;ESCO.0722.00348.0342;ESCO.0722.00348.0342b_04963;2;112;110
ESCO.0722.00348;ESCO.0722.00348.0029;ESCO.0722.00348.0029i_03179;12478;12900;422
ESCO.0722.00348;ESCO.0722.00348.0029;ESCO.0722.00348.0029i_03211;34127;35197;1070
ESCO.0722.00348;ESCO.0722.00348.0269;ESCO.0722.00348.0269b_04907;3;224;221
ESCO.0722.00348;ESCO.0722.00348.0353;ESCO.0722.00348.0353b_04971;3;110;107
ESCO.0722.00348;ESCO.0722.00348.0029;ESCO.0722.00348.0029i_03180;12902;14245;1343
ESCO.0722.00348;ESCO.0722.00348.0029;ESCO.0722.00348.0029i_03212;35175;35546;371
ESCO.0722.00348;ESCO.0722.00348.0149;ESCO.0722.00348.0149b_04780;715;858;143
ESCO.0722.00348;ESCO.0722.00348.0307;ESCO.0722.00348.0307b_04940;1;189;188
ESCO.0722.00348;ESCO.0722.00348.0271;ESCO.0722.00348.0271b_04909;2;223;221
ESCO.0722.00348;ESCO.0722.00348.0359;ESCO.0722.00348.0359b_04973;1;102;101
ESCO.0722.00348;ESCO.0722.00348.0283;ESCO.0722.00348.0283b_04921;2;220;218
ESCO.0722.00348;ESCO.0722.00348.0384;ESCO.0722.00348.0384b_04985;3;74;71
ESCO.0722.00348;ESCO.0722.00348.0159;ESCO.0722.00348.0159b_04794;86;316;230
ESCO.0722.00348;ESCO.0722.00348.0284;ESCO.0722.00348.0284b_04922;2;220;218
ESCO.0722.00348;ESCO.0722.00348.0028;ESCO.0722.00348.0028b_03163;67581;67730;149
ESCO.0722.00348;ESCO.0722.00348.0285;ESCO.0722.00348.0285b_04923;1;204;203
ESCO.0722.00352;ESCO.0722.00352.0009;ESCO.0722.00352.0009i_01506;155774;156961;1187
ESCO.0722.00352;ESCO.0722.00352.0025;ESCO.0722.00352.0025i_02882;1198;2088;890
ESCO.0722.00352;ESCO.0722.00352.0042;ESCO.0722.00352.0042i_03714;23360;24088;728
ESCO.0722.00352;ESCO.0722.00352.0050;ESCO.0722.00352.0050i_04002;16919;17791;872
ESCO.0722.00352;ESCO.0722.00352.0062;ESCO.0722.00352.0062i_04322;2841;3470;629
ESCO.0722.00352;ESCO.0722.00352.0063;ESCO.0722.00352.0063i_04354;17401;18879;1478
ESCO.0722.00352;ESCO.0722.00352.0069;ESCO.0722.00352.0069i_04450;10877;11227;350
ESCO.0722.00352;ESCO.0722.00352.0077;ESCO.0722.00352.0077i_04546;465;587;122
ESCO.0722.00352;ESCO.0722.00352.0103;ESCO.0722.00352.0103b_04706;2746;2883;137
ESCO.0722.00352;ESCO.0722.00352.0131;ESCO.0722.00352.0131b_04770;1;135;134
ESCO.0722.00352;ESCO.0722.00352.0204;ESCO.0722.00352.0204b_04866;2;301;299
ESCO.0722.00352;ESCO.0722.00352.0235;ESCO.0722.00352.0235b_04898;156;269;113
ESCO.0722.00352;ESCO.0722.00352.0278;ESCO.0722.00352.0278b_04930;32;211;179
ESCO.0722.00352;ESCO.0722.00352.0322;ESCO.0722.00352.0322b_04962;1;126;125
ESCO.0722.00352;ESCO.0722.00352.0369;ESCO.0722.00352.0369b_04994;2;94;92
ESCO.0722.00352;ESCO.0722.00352.0031;ESCO.0722.00352.0031i_03249;52431;53003;572
ESCO.0722.00352;ESCO.0722.00352.0037;ESCO.0722.00352.0037i_03505;17666;18232;566
ESCO.0722.00352;ESCO.0722.00352.0050;ESCO.0722.00352.0050i_03985;4478;5155;677
ESCO.0722.00352;ESCO.0722.00352.0050;ESCO.0722.00352.0050i_04017;27382;28305;923
ESCO.0722.00352;ESCO.0722.00352.0068;ESCO.0722.00352.0068i_04433;5279;7591;2312
ESCO.0722.00352;ESCO.0722.00352.0073;ESCO.0722.00352.0073i_04497;219;617;398
ESCO.0722.00352;ESCO.0722.00352.0078;ESCO.0722.00352.0078i_04561;4850;6055;1205
ESCO.0722.00352;ESCO.0722.00352.0142;ESCO.0722.00352.0142b_04785;191;454;263
ESCO.0722.00352;ESCO.0722.00352.0163;ESCO.0722.00352.0163b_04817;3;320;317
ESCO.0722.00352;ESCO.0722.00352.0218;ESCO.0722.00352.0218b_04881;1;315;314
ESCO.0722.00352;ESCO.0722.00352.0037;ESCO.0722.00352.0037i_03506;18226;18768;542
ESCO.0722.00352;ESCO.0722.00352.0050;ESCO.0722.00352.0050i_03986;5152;5322;170
ESCO.0722.00352;ESCO.0722.00352.0050;ESCO.0722.00352.0050i_04018;28837;29019;182
ESCO.0722.00352;ESCO.0722.00352.0068;ESCO.0722.00352.0068i_04434;7676;8656;980
ESCO.0722.00352;ESCO.0722.00352.0073;ESCO.0722.00352.0073i_04498;630;1253;623
ESCO.0722.00352;ESCO.0722.00352.0078;ESCO.0722.00352.0078i_04562;6141;6434;293
ESCO.0722.00352;ESCO.0722.00352.0085;ESCO.0722.00352.0085b_04626;6309;6899;590
ESCO.0722.00352;ESCO.0722.00352.0099;ESCO.0722.00352.0099b_04690;3;209;206
ESCO.0722.00352;ESCO.0722.00352.0143;ESCO.0722.00352.0143b_04786;3;584;581
ESCO.0722.00352;ESCO.0722.00352.0163;ESCO.0722.00352.0163b_04818;310;546;236
ESCO.0722.00352;ESCO.0722.00352.0296;ESCO.0722.00352.0296b_04946;3;176;173
ESCO.0722.00352;ESCO.0722.00352.0345;ESCO.0722.00352.0345b_04978;3;110;107
ESCO.0722.00352;ESCO.0722.00352.0029;ESCO.0722.00352.0029i_03123;3481;3651;170
ESCO.0722.00352;ESCO.0722.00352.0032;ESCO.0722.00352.0032b_03251;1;78;77
ESCO.0722.00352;ESCO.0722.00352.0037;ESCO.0722.00352.0037i_03507;18755;21280;2525
ESCO.0722.00352;ESCO.0722.00352.0050;ESCO.0722.00352.0050i_04019;28975;29232;257
ESCO.0722.00352;ESCO.0722.00352.0068;ESCO.0722.00352.0068i_04435;8682;11531;2849
ESCO.0722.00352;ESCO.0722.00352.0073;ESCO.0722.00352.0073i_04499;1256;1537;281
ESCO.0722.00352;ESCO.0722.00352.0078;ESCO.0722.00352.0078i_04563;6802;7674;872
ESCO.0722.00352;ESCO.0722.00352.0092;ESCO.0722.00352.0092i_04659;1987;2730;743
ESCO.0722.00352;ESCO.0722.00352.0143;ESCO.0722.00352.0143b_04787;581;847;266
ESCO.0722.00352;ESCO.0722.00352.0164;ESCO.0722.00352.0164b_04819;77;538;461
ESCO.0722.00352;ESCO.0722.00352.0298;ESCO.0722.00352.0298b_04947;6;173;167
ESCO.0722.00352;ESCO.0722.00352.0348;ESCO.0722.00352.0348b_04979;3;110;107
ESCO.0722.00352;ESCO.0722.00352.0015;ESCO.0722.00352.0015i_02151;27012;28124;1112
ESCO.0722.00352;ESCO.0722.00352.0034;ESCO.0722.00352.0034i_03399;48585;48827;242
ESCO.0722.00352;ESCO.0722.00352.0037;ESCO.0722.00352.0037i_03495;6541;6723;182
ESCO.0722.00352;ESCO.0722.00352.0055;ESCO.0722.00352.0055b_04135;31;627;596
ESCO.0722.00352;ESCO.0722.00352.0077;ESCO.0722.00352.0077i_04551;4885;5325;440
ESCO.0722.00352;ESCO.0722.00352.0104;ESCO.0722.00352.0104b_04711;2021;2710;689
ESCO.0722.00352;ESCO.0722.00352.0242;ESCO.0722.00352.0242b_04903;3;257;254
ESCO.0722.00352;ESCO.0722.00352.0375;ESCO.0722.00352.0375b_04999;3;86;83
ESCO.0722.00352;ESCO.0722.00352.0015;ESCO.0722.00352.0015i_02152;28121;29071;950
ESCO.0722.00352;ESCO.0722.00352.0029;ESCO.0722.00352.0029i_03144;12795;13466;671
ESCO.0722.00352;ESCO.0722.00352.0034;ESCO.0722.00352.0034b_03400;48895;49206;311
ESCO.0722.00352;ESCO.0722.00352.0041;ESCO.0722.00352.0041i_03688;41138;41587;449
ESCO.0722.00352;ESCO.0722.00352.0042;ESCO.0722.00352.0042i_03720;26394;28517;2123
ESCO.0722.00352;ESCO.0722.00352.0074;ESCO.0722.00352.0074i_04520;10156;11082;926
ESCO.0722.00352;ESCO.0722.00352.0077;ESCO.0722.00352.0077i_04552;5339;7594;2255
ESCO.0722.00352;ESCO.0722.00352.0008;ESCO.0722.00352.0008i_01280;82009;82356;347
ESCO.0722.00352;ESCO.0722.00352.0009;ESCO.0722.00352.0009i_01440;92238;92501;263
ESCO.0722.00352;ESCO.0722.00352.0021;ESCO.0722.00352.0021i_02560;16003;16293;290
ESCO.0722.00352;ESCO.0722.00352.0037;ESCO.0722.00352.0037i_03520;35535;35936;401
ESCO.0722.00352;ESCO.0722.00352.0042;ESCO.0722.00352.0042i_03712;22867;23124;257
ESCO.0722.00352;ESCO.0722.00352.0062;ESCO.0722.00352.0062b_04320;788;1084;296
ESCO.0722.00352;ESCO.0722.00352.0063;ESCO.0722.00352.0063i_04352;16453;16875;422
ESCO.0722.00352;ESCO.0722.00352.0069;ESCO.0722.00352.0069i_04448;8816;9220;404
ESCO.0722.00352;ESCO.0722.00352.0077;ESCO.0722.00352.0077b_04544;3;149;146
ESCO.0722.00352;ESCO.0722.00352.0115;ESCO.0722.00352.0115b_04736;191;385;194
ESCO.0722.00352;ESCO.0722.00352.0173;ESCO.0722.00352.0173b_04832;1;474;473
ESCO.0722.00352;ESCO.0722.00352.0276;ESCO.0722.00352.0276b_04928;2;214;212
ESCO.0722.00352;ESCO.0722.00352.0319;ESCO.0722.00352.0319b_04960;3;131;128
ESCO.0722.00352;ESCO.0722.00352.0001;ESCO.0722.00352.0001i_00026;25222;26958;1736
ESCO.0722.00352;ESCO.0722.00352.0018;ESCO.0722.00352.0018i_02426;84485;84688;203
ESCO.0722.00352;ESCO.0722.00352.0037;ESCO.0722.00352.0037i_03514;29309;30907;1598
ESCO.0722.00352;ESCO.0722.00352.0063;ESCO.0722.00352.0063i_04346;9873;10949;1076
ESCO.0722.00352;ESCO.0722.00352.0069;ESCO.0722.00352.0069i_04442;3285;4523;1238
ESCO.0722.00352;ESCO.0722.00352.0093;ESCO.0722.00352.0093i_04666;2723;3289;566
ESCO.0722.00352;ESCO.0722.00352.0101;ESCO.0722.00352.0101i_04698;820;1515;695
ESCO.0722.00352;ESCO.0722.00352.0112;ESCO.0722.00352.0112b_04730;25;162;137
ESCO.0722.00352;ESCO.0722.00352.0168;ESCO.0722.00352.0168b_04826;186;512;326
ESCO.0722.00352;ESCO.0722.00352.0195;ESCO.0722.00352.0195b_04858;2;391;389
ESCO.0722.00352;ESCO.0722.00352.0266;ESCO.0722.00352.0266b_04922;2;223;221
ESCO.0722.00352;ESCO.0722.00352.0307;ESCO.0722.00352.0307b_04954;3;146;143
ESCO.0722.00352;ESCO.0722.00352.0360;ESCO.0722.00352.0360b_04986;3;104;101
ESCO.0722.00352;ESCO.0722.00352.0037;ESCO.0722.00352.0037i_03515;30909;31601;692
ESCO.0722.00352;ESCO.0722.00352.0063;ESCO.0722.00352.0063i_04347;10953;11252;299
ESCO.0722.00352;ESCO.0722.00352.0069;ESCO.0722.00352.0069i_04443;4520;5665;1145
ESCO.0722.00352;ESCO.0722.00352.0093;ESCO.0722.00352.0093i_04667;3876;4085;209
ESCO.0722.00352;ESCO.0722.00352.0101;ESCO.0722.00352.0101i_04699;1528;2181;653
ESCO.0722.00352;ESCO.0722.00352.0169;ESCO.0722.00352.0169b_04827;1;507;506
ESCO.0722.00352;ESCO.0722.00352.0196;ESCO.0722.00352.0196b_04859;3;389;386
ESCO.0722.00352;ESCO.0722.00352.0268;ESCO.0722.00352.0268b_04923;3;74;71
ESCO.0722.00352;ESCO.0722.00352.0001;ESCO.0722.00352.0001i_00023;22520;23236;716
ESCO.0722.00352;ESCO.0722.00352.0018;ESCO.0722.00352.0018i_02423;82739;83086;347
ESCO.0722.00352;ESCO.0722.00352.0026;ESCO.0722.00352.0026i_02999;51423;52715;1292
ESCO.0722.00352;ESCO.0722.00352.0033;ESCO.0722.00352.0033i_03319;10403;10513;110
ESCO.0722.00352;ESCO.0722.00352.0037;ESCO.0722.00352.0037i_03511;24509;24775;266
ESCO.0722.00352;ESCO.0722.00352.0042;ESCO.0722.00352.0042b_03735;41150;41629;479
ESCO.0722.00352;ESCO.0722.00352.0063;ESCO.0722.00352.0063i_04343;7541;7759;218
ESCO.0722.00352;ESCO.0722.00352.0069;ESCO.0722.00352.0069b_04439;722;1933;1211
ESCO.0722.00352;ESCO.0722.00352.0073;ESCO.0722.00352.0073i_04503;5415;5627;212
ESCO.0722.00352;ESCO.0722.00352.0083;ESCO.0722.00352.0083i_04599;270;785;515
ESCO.0722.00352;ESCO.0722.00352.0122;ESCO.0722.00352.0122b_04759;1;1422;1421
ESCO.0722.00352;ESCO.0722.00352.0224;ESCO.0722.00352.0224b_04887;1;126;125
ESCO.0722.00352;ESCO.0722.00352.0262;ESCO.0722.00352.0262b_04919;3;227;224
ESCO.0722.00352;ESCO.0722.00352.0357;ESCO.0722.00352.0357b_04983;1;105;104
ESCO.0722.00352;ESCO.0722.00352.0001;ESCO.0722.00352.0001i_00024;23243;24613;1370
ESCO.0722.00352;ESCO.0722.00352.0018;ESCO.0722.00352.0018i_02424;83116;83766;650
ESCO.0722.00352;ESCO.0722.00352.0026;ESCO.0722.00352.0026i_03000;52839;53567;728
ESCO.0722.00352;ESCO.0722.00352.0036;ESCO.0722.00352.0036i_03448;1565;2041;476
ESCO.0722.00352;ESCO.0722.00352.0037;ESCO.0722.00352.0037i_03512;24779;25927;1148
ESCO.0722.00352;ESCO.0722.00352.0063;ESCO.0722.00352.0063i_04344;7883;9295;1412
ESCO.0722.00352;ESCO.0722.00352.0066;ESCO.0722.00352.0066i_04408;10566;10784;218
ESCO.0722.00352;ESCO.0722.00352.0069;ESCO.0722.00352.0069i_04440;1945;2574;629
ESCO.0722.00352;ESCO.0722.00352.0073;ESCO.0722.00352.0073i_04504;5624;7747;2123
ESCO.0722.00352;ESCO.0722.00352.0093;ESCO.0722.00352.0093b_04664;1090;2244;1154
ESCO.0722.00352;ESCO.0722.00352.0193;ESCO.0722.00352.0193b_04856;329;394;65
ESCO.0722.00352;ESCO.0722.00352.0018;ESCO.0722.00352.0018i_02425;83782;84186;404
ESCO.0722.00352;ESCO.0722.00352.0021;ESCO.0722.00352.0021i_02553;11800;12597;797
ESCO.0722.00352;ESCO.0722.00352.0037;ESCO.0722.00352.0037i_03513;25920;29309;3389
ESCO.0722.00352;ESCO.0722.00352.0063;ESCO.0722.00352.0063i_04345;9314;9865;551
ESCO.0722.00352;ESCO.0722.00352.0069;ESCO.0722.00352.0069i_04441;2567;3205;638
ESCO.0722.00352;ESCO.0722.00352.0073;ESCO.0722.00352.0073i_04505;7744;8220;476
ESCO.0722.00352;ESCO.0722.00352.0093;ESCO.0722.00352.0093i_04665;2563;2658;95
ESCO.0722.00352;ESCO.0722.00352.0111;ESCO.0722.00352.0111b_04729;665;1690;1025
ESCO.0722.00352;ESCO.0722.00352.0168;ESCO.0722.00352.0168b_04825;2;205;203
ESCO.0722.00352;ESCO.0722.00352.0194;ESCO.0722.00352.0194b_04857;3;392;389
ESCO.0722.00352;ESCO.0722.00352.0226;ESCO.0722.00352.0226b_04889;1;291;290
ESCO.0722.00352;ESCO.0722.00352.0306;ESCO.0722.00352.0306b_04953;3;146;143
ESCO.0722.00352;ESCO.0722.00352.0359;ESCO.0722.00352.0359b_04985;3;104;101
ESCO.0722.00352;ESCO.0722.00352.0009;ESCO.0722.00352.0009i_01441;92544;93293;749
ESCO.0722.00352;ESCO.0722.00352.0021;ESCO.0722.00352.0021i_02561;16290;18422;2132
ESCO.0722.00352;ESCO.0722.00352.0037;ESCO.0722.00352.0037i_03521;36169;37335;1166
ESCO.0722.00352;ESCO.0722.00352.0042;ESCO.0722.00352.0042i_03713;23139;23360;221
ESCO.0722.00352;ESCO.0722.00352.0062;ESCO.0722.00352.0062i_04321;1714;2790;1076
ESCO.0722.00352;ESCO.0722.00352.0063;ESCO.0722.00352.0063i_04353;16885;17391;506
ESCO.0722.00352;ESCO.0722.00352.0069;ESCO.0722.00352.0069i_04449;9946;10146;200
ESCO.0722.00352;ESCO.0722.00352.0077;ESCO.0722.00352.0077i_04545;331;483;152
ESCO.0722.00352;ESCO.0722.00352.0115;ESCO.0722.00352.0115i_04737;374;712;338
ESCO.0722.00352;ESCO.0722.00352.0277;ESCO.0722.00352.0277b_04929;98;214;116
ESCO.0722.00352;ESCO.0722.00352.0014;ESCO.0722.00352.0014i_02092;94453;94566;113
ESCO.0722.00352;ESCO.0722.00352.0015;ESCO.0722.00352.0015i_02156;32632;33252;620
ESCO.0722.00352;ESCO.0722.00352.0021;ESCO.0722.00352.0021i_02572;25298;25393;95
ESCO.0722.00352;ESCO.0722.00352.0037;ESCO.0722.00352.0037i_03500;10626;11963;1337
ESCO.0722.00352;ESCO.0722.00352.0037;ESCO.0722.00352.0037i_03532;46641;46847;206
ESCO.0722.00352;ESCO.0722.00352.0050;ESCO.0722.00352.0050b_03980;180;1220;1040
ESCO.0722.00352;ESCO.0722.00352.0050;ESCO.0722.00352.0050i_04012;23623;24054;431
ESCO.0722.00352;ESCO.0722.00352.0072;ESCO.0722.00352.0072i_04492;9579;10646;1067
ESCO.0722.00352;ESCO.0722.00352.0249;ESCO.0722.00352.0249b_04908;3;245;242
ESCO.0722.00352;ESCO.0722.00352.0287;ESCO.0722.00352.0287b_04940;1;204;203
ESCO.0722.00352;ESCO.0722.00352.0336;ESCO.0722.00352.0336b_04972;2;112;110
ESCO.0722.00352;ESCO.0722.00352.0385;ESCO.0722.00352.0385b_05004;3;68;65
ESCO.0722.00352;ESCO.0722.00352.0014;ESCO.0722.00352.0014i_02093;94570;94992;422
ESCO.0722.00352;ESCO.0722.00352.0029;ESCO.0722.00352.0029i_03117;453;656;203
ESCO.0722.00352;ESCO.0722.00352.0037;ESCO.0722.00352.0037i_03501;11960;12613;653
ESCO.0722.00352;ESCO.0722.00352.0037;ESCO.0722.00352.0037b_03533;47335;47586;251
ESCO.0722.00352;ESCO.0722.00352.0048;ESCO.0722.00352.0048b_03917;32;820;788
ESCO.0722.00352;ESCO.0722.00352.0050;ESCO.0722.00352.0050i_03981;1429;1830;401
ESCO.0722.00352;ESCO.0722.00352.0072;ESCO.0722.00352.0072i_04493;10588;11208;620
ESCO.0722.00352;ESCO.0722.00352.0119;ESCO.0722.00352.0119b_04749;50;553;503
ESCO.0722.00352;ESCO.0722.00352.0214;ESCO.0722.00352.0214b_04877;2;328;326
ESCO.0722.00352;ESCO.0722.00352.0250;ESCO.0722.00352.0250b_04909;3;242;239
ESCO.0722.00352;ESCO.0722.00352.0002;ESCO.0722.00352.0002b_00265;11;346;335
ESCO.0722.00352;ESCO.0722.00352.0015;ESCO.0722.00352.0015i_02153;29156;30319;1163
ESCO.0722.00352;ESCO.0722.00352.0021;ESCO.0722.00352.0021i_02569;22202;22729;527
ESCO.0722.00352;ESCO.0722.00352.0041;ESCO.0722.00352.0041i_03689;41566;41745;179
ESCO.0722.00352;ESCO.0722.00352.0042;ESCO.0722.00352.0042i_03721;28502;29845;1343
ESCO.0722.00352;ESCO.0722.00352.0050;ESCO.0722.00352.0050i_04009;21886;22011;125
ESCO.0722.00352;ESCO.0722.00352.0074;ESCO.0722.00352.0074b_04521;11419;11586;167
ESCO.0722.00352;ESCO.0722.00352.0077;ESCO.0722.00352.0077b_04553;7942;8844;902
ESCO.0722.00352;ESCO.0722.00352.0210;ESCO.0722.00352.0210b_04873;1;339;338
ESCO.0722.00352;ESCO.0722.00352.0284;ESCO.0722.00352.0284b_04937;3;206;203
ESCO.0722.00352;ESCO.0722.00352.0332;ESCO.0722.00352.0332b_04969;1;114;113
ESCO.0722.00352;ESCO.0722.00352.0378;ESCO.0722.00352.0378b_05001;1;78;77
ESCO.0722.00352;ESCO.0722.00352.0007;ESCO.0722.00352.0007i_01162;128840;129169;329
ESCO.0722.00352;ESCO.0722.00352.0015;ESCO.0722.00352.0015b_02122;3;119;116
ESCO.0722.00352;ESCO.0722.00352.0015;ESCO.0722.00352.0015i_02154;30316;31581;1265
ESCO.0722.00352;ESCO.0722.00352.0021;ESCO.0722.00352.0021i_02570;23345;24328;983
ESCO.0722.00352;ESCO.0722.00352.0029;ESCO.0722.00352.0029i_03146;14035;14664;629
ESCO.0722.00352;ESCO.0722.00352.0037;ESCO.0722.00352.0037i_03498;8547;9044;497
ESCO.0722.00352;ESCO.0722.00352.0037;ESCO.0722.00352.0037i_03530;45697;46020;323
ESCO.0722.00352;ESCO.0722.00352.0075;ESCO.0722.00352.0075b_04522;1;141;140
ESCO.0722.00352;ESCO.0722.00352.0106;ESCO.0722.00352.0106b_04714;51;728;677
ESCO.0722.00352;ESCO.0722.00352.0137;ESCO.0722.00352.0137b_04778;3;1007;1004
ESCO.0722.00352;ESCO.0722.00352.0181;ESCO.0722.00352.0181b_04842;2;283;281
ESCO.0722.00352;ESCO.0722.00352.0211;ESCO.0722.00352.0211b_04874;3;338;335
ESCO.0722.00352;ESCO.0722.00352.0247;ESCO.0722.00352.0247b_04906;3;248;245
ESCO.0722.00352;ESCO.0722.00352.0285;ESCO.0722.00352.0285b_04938;34;204;170
ESCO.0722.00352;ESCO.0722.00352.0381;ESCO.0722.00352.0381b_05002;2;76;74
ESCO.0722.00352;ESCO.0722.00352.0007;ESCO.0722.00352.0007i_01163;129233;129676;443
ESCO.0722.00352;ESCO.0722.00352.0015;ESCO.0722.00352.0015i_02155;31587;32627;1040
ESCO.0722.00352;ESCO.0722.00352.0021;ESCO.0722.00352.0021i_02571;24321;25301;980
ESCO.0722.00352;ESCO.0722.00352.0037;ESCO.0722.00352.0037i_03499;9066;10610;1544
ESCO.0722.00352;ESCO.0722.00352.0037;ESCO.0722.00352.0037i_03531;46051;46248;197
ESCO.0722.00352;ESCO.0722.00352.0049;ESCO.0722.00352.0049b_03979;33487;34863;1376
ESCO.0722.00352;ESCO.0722.00352.0248;ESCO.0722.00352.0248b_04907;1;246;245
ESCO.0722.00352;ESCO.0722.00352.0286;ESCO.0722.00352.0286b_04939;1;204;203
ESCO.0722.00352;ESCO.0722.00352.0382;ESCO.0722.00352.0382b_05003;2;70;68
ESCO.0722.00352;ESCO.0722.00352.0037;ESCO.0722.00352.0037i_03508;21277;22959;1682
ESCO.0722.00352;ESCO.0722.00352.0050;ESCO.0722.00352.0050i_03988;6955;7215;260
ESCO.0722.00352;ESCO.0722.00352.0063;ESCO.0722.00352.0063i_04340;991;3540;2549
ESCO.0722.00352;ESCO.0722.00352.0068;ESCO.0722.00352.0068i_04436;11942;12535;593
ESCO.0722.00352;ESCO.0722.00352.0073;ESCO.0722.00352.0073i_04500;1530;1856;326
ESCO.0722.00352;ESCO.0722.00352.0078;ESCO.0722.00352.0078b_04564;7919;8389;470
ESCO.0722.00352;ESCO.0722.00352.0086;ESCO.0722.00352.0086i_04628;1048;4905;3857
ESCO.0722.00352;ESCO.0722.00352.0092;ESCO.0722.00352.0092i_04660;2727;3491;764
ESCO.0722.00352;ESCO.0722.00352.0221;ESCO.0722.00352.0221b_04884;1;303;302
ESCO.0722.00352;ESCO.0722.00352.0350;ESCO.0722.00352.0350b_04980;1;108;107
ESCO.0722.00352;ESCO.0722.00352.0028;ESCO.0722.00352.0028i_03093;22185;22808;623
ESCO.0722.00352;ESCO.0722.00352.0050;ESCO.0722.00352.0050i_03989;7540;8373;833
ESCO.0722.00352;ESCO.0722.00352.0063;ESCO.0722.00352.0063i_04341;3544;6948;3404
ESCO.0722.00352;ESCO.0722.00352.0073;ESCO.0722.00352.0073i_04501;1944;3968;2024
ESCO.0722.00352;ESCO.0722.00352.0086;ESCO.0722.00352.0086i_04629;5266;6066;800
ESCO.0722.00352;ESCO.0722.00352.0222;ESCO.0722.00352.0222b_04885;2;304;302
ESCO.0722.00352;ESCO.0722.00352.0259;ESCO.0722.00352.0259b_04917;52;231;179
ESCO.0722.00352;ESCO.0722.00352.0351;ESCO.0722.00352.0351b_04981;1;108;107
ESCO.0722.00352;ESCO.0722.00352.0018;ESCO.0722.00352.0018i_02422;81732;82733;1001
ESCO.0722.00352;ESCO.0722.00352.0029;ESCO.0722.00352.0029i_03126;4437;4751;314
ESCO.0722.00352;ESCO.0722.00352.0033;ESCO.0722.00352.0033i_03318;10004;10306;302
ESCO.0722.00352;ESCO.0722.00352.0063;ESCO.0722.00352.0063i_04342;6954;7544;590
ESCO.0722.00352;ESCO.0722.00352.0073;ESCO.0722.00352.0073i_04502;3913;5415;1502
ESCO.0722.00352;ESCO.0722.00352.0083;ESCO.0722.00352.0083b_04598;3;149;146
ESCO.0722.00352;ESCO.0722.00352.0086;ESCO.0722.00352.0086b_04630;6583;6687;104
ESCO.0722.00352;ESCO.0722.00352.0166;ESCO.0722.00352.0166b_04822;3;425;422
ESCO.0722.00352;ESCO.0722.00352.0354;ESCO.0722.00352.0354b_04982;1;108;107
ESCO.0722.00352;ESCO.0722.00352.0008;ESCO.0722.00352.0008i_01279;81016;82002;986
ESCO.0722.00352;ESCO.0722.00352.0021;ESCO.0722.00352.0021i_02559;15798;15998;200
ESCO.0722.00352;ESCO.0722.00352.0037;ESCO.0722.00352.0037i_03487;2413;2628;215
ESCO.0722.00352;ESCO.0722.00352.0037;ESCO.0722.00352.0037i_03519;34947;35378;431
ESCO.0722.00352;ESCO.0722.00352.0042;ESCO.0722.00352.0042i_03711;20755;22734;1979
ESCO.0722.00352;ESCO.0722.00352.0061;ESCO.0722.00352.0061b_04319;20097;21329;1232
ESCO.0722.00352;ESCO.0722.00352.0063;ESCO.0722.00352.0063i_04351;14658;16460;1802
ESCO.0722.00352;ESCO.0722.00352.0069;ESCO.0722.00352.0069i_04447;7696;8112;416
ESCO.0722.00352;ESCO.0722.00352.0201;ESCO.0722.00352.0201b_04863;2;214;212
ESCO.0722.00352;ESCO.0722.00352.0232;ESCO.0722.00352.0232b_04895;1;282;281
ESCO.0722.00352;ESCO.0722.00352.0318;ESCO.0722.00352.0318b_04959;2;139;137
ESCO.0722.00352;ESCO.0722.00352.0001;ESCO.0722.00352.0001i_00099;107272;107484;212
ESCO.0722.00352;ESCO.0722.00352.0009;ESCO.0722.00352.0009b_01507;157290;158447;1157
ESCO.0722.00352;ESCO.0722.00352.0037;ESCO.0722.00352.0037i_03491;4629;4802;173
ESCO.0722.00352;ESCO.0722.00352.0037;ESCO.0722.00352.0037i_03523;39378;39686;308
ESCO.0722.00352;ESCO.0722.00352.0042;ESCO.0722.00352.0042i_03715;24177;24887;710
ESCO.0722.00352;ESCO.0722.00352.0050;ESCO.0722.00352.0050i_04003;17788;18003;215
ESCO.0722.00352;ESCO.0722.00352.0058;ESCO.0722.00352.0058b_04227;3;725;722
ESCO.0722.00352;ESCO.0722.00352.0063;ESCO.0722.00352.0063b_04355;18882;19358;476
ESCO.0722.00352;ESCO.0722.00352.0069;ESCO.0722.00352.0069i_04451;12067;12864;797
ESCO.0722.00352;ESCO.0722.00352.0077;ESCO.0722.00352.0077i_04547;986;1525;539
ESCO.0722.00352;ESCO.0722.00352.0104;ESCO.0722.00352.0104b_04707;3;194;191
ESCO.0722.00352;ESCO.0722.00352.0204;ESCO.0722.00352.0204b_04867;298;375;77
ESCO.0722.00352;ESCO.0722.00352.0236;ESCO.0722.00352.0236b_04899;2;268;266
ESCO.0722.00352;ESCO.0722.00352.0279;ESCO.0722.00352.0279b_04931;3;209;206
ESCO.0722.00352;ESCO.0722.00352.0370;ESCO.0722.00352.0370b_04995;3;92;89
ESCO.0722.00352;ESCO.0722.00352.0015;ESCO.0722.00352.0015i_02148;23675;24481;806
ESCO.0722.00352;ESCO.0722.00352.0021;ESCO.0722.00352.0021i_02564;19685;19807;122
ESCO.0722.00352;ESCO.0722.00352.0037;ESCO.0722.00352.0037i_03524;39741;41108;1367
ESCO.0722.00352;ESCO.0722.00352.0042;ESCO.0722.00352.0042i_03716;24877;25050;173
ESCO.0722.00352;ESCO.0722.00352.0050;ESCO.0722.00352.0050i_04004;18023;18478;455
ESCO.0722.00352;ESCO.0722.00352.0059;ESCO.0722.00352.0059b_04260;49;351;302
ESCO.0722.00352;ESCO.0722.00352.0069;ESCO.0722.00352.0069b_04452;12965;13369;404
ESCO.0722.00352;ESCO.0722.00352.0077;ESCO.0722.00352.0077i_04548;1529;2557;1028
ESCO.0722.00352;ESCO.0722.00352.0324;ESCO.0722.00352.0324b_04964;3;122;119
ESCO.0722.00352;ESCO.0722.00352.0371;ESCO.0722.00352.0371b_04996;3;92;89
ESCO.0722.00352;ESCO.0722.00352.0015;ESCO.0722.00352.0015i_02149;24506;25783;1277
ESCO.0722.00352;ESCO.0722.00352.0021;ESCO.0722.00352.0021i_02565;19857;20999;1142
ESCO.0722.00352;ESCO.0722.00352.0037;ESCO.0722.00352.0037i_03525;41323;41883;560
ESCO.0722.00352;ESCO.0722.00352.0042;ESCO.0722.00352.0042i_03717;25162;25482;320
ESCO.0722.00352;ESCO.0722.00352.0077;ESCO.0722.00352.0077i_04549;3041;3943;902
ESCO.0722.00352;ESCO.0722.00352.0089;ESCO.0722.00352.0089i_04645;4171;4497;326
ESCO.0722.00352;ESCO.0722.00352.0116;ESCO.0722.00352.0116b_04741;323;838;515
ESCO.0722.00352;ESCO.0722.00352.0176;ESCO.0722.00352.0176b_04837;2;157;155
ESCO.0722.00352;ESCO.0722.00352.0238;ESCO.0722.00352.0238b_04901;2;265;263
ESCO.0722.00352;ESCO.0722.00352.0281;ESCO.0722.00352.0281b_04933;65;211;146
ESCO.0722.00352;ESCO.0722.00352.0015;ESCO.0722.00352.0015i_02150;25783;27006;1223
ESCO.0722.00352;ESCO.0722.00352.0021;ESCO.0722.00352.0021i_02566;21064;21387;323
ESCO.0722.00352;ESCO.0722.00352.0034;ESCO.0722.00352.0034i_03398;47588;48607;1019
ESCO.0722.00352;ESCO.0722.00352.0037;ESCO.0722.00352.0037i_03494;6123;6239;116
ESCO.0722.00352;ESCO.0722.00352.0037;ESCO.0722.00352.0037i_03526;41886;42716;830
ESCO.0722.00352;ESCO.0722.00352.0047;ESCO.0722.00352.0047i_03910;31879;32430;551
ESCO.0722.00352;ESCO.0722.00352.0050;ESCO.0722.00352.0050i_04006;19722;20390;668
ESCO.0722.00352;ESCO.0722.00352.0077;ESCO.0722.00352.0077i_04550;4210;4710;500
ESCO.0722.00352;ESCO.0722.00352.0089;ESCO.0722.00352.0089b_04646;4580;4681;101
ESCO.0722.00352;ESCO.0722.00352.0133;ESCO.0722.00352.0133b_04774;2;1060;1058
ESCO.0722.00352;ESCO.0722.00352.0207;ESCO.0722.00352.0207b_04870;3;350;347
ESCO.0722.00352;ESCO.0722.00352.0282;ESCO.0722.00352.0282b_04934;3;209;206
ESCO.0722.00352;ESCO.0722.00352.0019;ESCO.0722.00352.0019i_02478;26000;29746;3746
ESCO.0722.00352;ESCO.0722.00352.0037;ESCO.0722.00352.0037i_03502;12616;14346;1730
ESCO.0722.00352;ESCO.0722.00352.0059;ESCO.0722.00352.0059i_04270;7680;10568;2888
ESCO.0722.00352;ESCO.0722.00352.0068;ESCO.0722.00352.0068i_04430;386;679;293
ESCO.0722.00352;ESCO.0722.00352.0090;ESCO.0722.00352.0090b_04654;4397;5245;848
ESCO.0722.00352;ESCO.0722.00352.0159;ESCO.0722.00352.0159b_04814;349;585;236
ESCO.0722.00352;ESCO.0722.00352.0290;ESCO.0722.00352.0290b_04942;1;198;197
ESCO.0722.00352;ESCO.0722.00352.0338;ESCO.0722.00352.0338b_04974;1;72;71
ESCO.0722.00352;ESCO.0722.00352.0004;ESCO.0722.00352.0004i_00751;76331;76786;455
ESCO.0722.00352;ESCO.0722.00352.0005;ESCO.0722.00352.0005i_01007;158493;158687;194
ESCO.0722.00352;ESCO.0722.00352.0008;ESCO.0722.00352.0008b_01359;162077;162163;86
ESCO.0722.00352;ESCO.0722.00352.0048;ESCO.0722.00352.0048i_03919;2309;4432;2123
ESCO.0722.00352;ESCO.0722.00352.0068;ESCO.0722.00352.0068i_04431;768;3638;2870
ESCO.0722.00352;ESCO.0722.00352.0078;ESCO.0722.00352.0078i_04559;2305;3231;926
ESCO.0722.00352;ESCO.0722.00352.0119;ESCO.0722.00352.0119b_04751;1283;1654;371
ESCO.0722.00352;ESCO.0722.00352.0140;ESCO.0722.00352.0140b_04783;732;902;170
ESCO.0722.00352;ESCO.0722.00352.0217;ESCO.0722.00352.0217b_04879;1;108;107
ESCO.0722.00352;ESCO.0722.00352.0291;ESCO.0722.00352.0291b_04943;1;186;185
ESCO.0722.00352;ESCO.0722.00352.0339;ESCO.0722.00352.0339b_04975;2;109;107
ESCO.0722.00352;ESCO.0722.00352.0004;ESCO.0722.00352.0004i_00752;76783;77769;986
ESCO.0722.00352;ESCO.0722.00352.0037;ESCO.0722.00352.0037i_03504;15012;17669;2657
ESCO.0722.00352;ESCO.0722.00352.0050;ESCO.0722.00352.0050i_03984;3269;4261;992
ESCO.0722.00352;ESCO.0722.00352.0068;ESCO.0722.00352.0068i_04432;3641;5269;1628
ESCO.0722.00352;ESCO.0722.00352.0078;ESCO.0722.00352.0078i_04560;3221;4840;1619
ESCO.0722.00352;ESCO.0722.00352.0162;ESCO.0722.00352.0162b_04816;3;554;551
ESCO.0722.00352;ESCO.0722.00352.0186;ESCO.0722.00352.0186b_04848;3;410;407
ESCO.0722.00352;ESCO.0722.00352.0293;ESCO.0722.00352.0293b_04944;1;99;98
ESCO.0722.00352;ESCO.0722.00352.0343;ESCO.0722.00352.0343b_04976;2;109;107
ESCO.0722.00352;ESCO.0722.00352.0021;ESCO.0722.00352.0021i_02556;14586;14891;305
ESCO.0722.00352;ESCO.0722.00352.0037;ESCO.0722.00352.0037i_03516;31609;33372;1763
ESCO.0722.00352;ESCO.0722.00352.0050;ESCO.0722.00352.0050i_03996;13897;14589;692
ESCO.0722.00352;ESCO.0722.00352.0063;ESCO.0722.00352.0063i_04348;11262;11729;467
ESCO.0722.00352;ESCO.0722.00352.0069;ESCO.0722.00352.0069i_04444;6030;6278;248
ESCO.0722.00352;ESCO.0722.00352.0083;ESCO.0722.00352.0083i_04604;1813;2301;488
ESCO.0722.00352;ESCO.0722.00352.0093;ESCO.0722.00352.0093i_04668;4243;4362;119
ESCO.0722.00352;ESCO.0722.00352.0101;ESCO.0722.00352.0101b_04700;2496;3395;899
ESCO.0722.00352;ESCO.0722.00352.0112;ESCO.0722.00352.0112b_04732;1239;1745;506
ESCO.0722.00352;ESCO.0722.00352.0170;ESCO.0722.00352.0170b_04828;3;407;404
ESCO.0722.00352;ESCO.0722.00352.0198;ESCO.0722.00352.0198b_04860;3;386;383
ESCO.0722.00352;ESCO.0722.00352.0229;ESCO.0722.00352.0229b_04892;3;152;149
ESCO.0722.00352;ESCO.0722.00352.0269;ESCO.0722.00352.0269b_04924;1;222;221
ESCO.0722.00352;ESCO.0722.00352.0362;ESCO.0722.00352.0362b_04988;1;102;101
ESCO.0722.00352;ESCO.0722.00352.0021;ESCO.0722.00352.0021i_02557;15082;15447;365
ESCO.0722.00352;ESCO.0722.00352.0037;ESCO.0722.00352.0037i_03517;33336;34427;1091
ESCO.0722.00352;ESCO.0722.00352.0063;ESCO.0722.00352.0063i_04349;11740;13722;1982
ESCO.0722.00352;ESCO.0722.00352.0073;ESCO.0722.00352.0073i_04509;10445;10759;314
ESCO.0722.00352;ESCO.0722.00352.0093;ESCO.0722.00352.0093b_04669;4346;4495;149
ESCO.0722.00352;ESCO.0722.00352.0102;ESCO.0722.00352.0102b_04701;2;118;116
ESCO.0722.00352;ESCO.0722.00352.0151;ESCO.0722.00352.0151b_04797;3;233;230
ESCO.0722.00352;ESCO.0722.00352.0270;ESCO.0722.00352.0270b_04925;2;220;218
ESCO.0722.00352;ESCO.0722.00352.0363;ESCO.0722.00352.0363b_04989;3;101;98
ESCO.0722.00352;ESCO.0722.00352.0016;ESCO.0722.00352.0016i_02206;50524;51360;836
ESCO.0722.00352;ESCO.0722.00352.0029;ESCO.0722.00352.0029i_03134;9176;9613;437
ESCO.0722.00352;ESCO.0722.00352.0037;ESCO.0722.00352.0037i_03518;34408;34944;536
ESCO.0722.00352;ESCO.0722.00352.0042;ESCO.0722.00352.0042i_03710;18774;20684;1910
ESCO.0722.00352;ESCO.0722.00352.0057;ESCO.0722.00352.0057i_04222;19879;20073;194
ESCO.0722.00352;ESCO.0722.00352.0058;ESCO.0722.00352.0058i_04254;20699;20926;227
ESCO.0722.00352;ESCO.0722.00352.0061;ESCO.0722.00352.0061i_04318;19480;20088;608
ESCO.0722.00352;ESCO.0722.00352.0063;ESCO.0722.00352.0063i_04350;13735;14667;932
ESCO.0722.00352;ESCO.0722.00352.0069;ESCO.0722.00352.0069i_04446;6629;7378;749
ESCO.0722.00352;ESCO.0722.00352.0073;ESCO.0722.00352.0073i_04510;10769;11575;806
ESCO.0722.00352;ESCO.0722.00352.0364;ESCO.0722.00352.0364b_04990;3;101;98
ESCO.0722.00357;ESCO.0722.00357.0017;ESCO.0722.00357.0017i_02326;103909;104376;467
ESCO.0722.00357;ESCO.0722.00357.0036;ESCO.0722.00357.0036i_03382;58469;58618;149
ESCO.0722.00357;ESCO.0722.00357.0156;ESCO.0722.00357.0156b_04630;1;111;110
ESCO.0722.00357;ESCO.0722.00357.0170;ESCO.0722.00357.0170b_04662;943;1143;200
ESCO.0722.00357;ESCO.0722.00357.0213;ESCO.0722.00357.0213b_04726;317;616;299
ESCO.0722.00357;ESCO.0722.00357.0240;ESCO.0722.00357.0240b_04758;2;448;446
ESCO.0722.00357;ESCO.0722.00357.0272;ESCO.0722.00357.0272b_04790;2;349;347
ESCO.0722.00357;ESCO.0722.00357.0307;ESCO.0722.00357.0307b_04822;2;184;182
ESCO.0722.00357;ESCO.0722.00357.0343;ESCO.0722.00357.0343b_04854;2;232;230
ESCO.0722.00357;ESCO.0722.00357.0438;ESCO.0722.00357.0438b_04918;3;110;107
ESCO.0722.00357;ESCO.0722.00357.0036;ESCO.0722.00357.0036i_03365;43095;43691;596
ESCO.0722.00357;ESCO.0722.00357.0050;ESCO.0722.00357.0050i_03877;1658;1993;335
ESCO.0722.00357;ESCO.0722.00357.0055;ESCO.0722.00357.0055i_04069;10591;12054;1463
ESCO.0722.00357;ESCO.0722.00357.0064;ESCO.0722.00357.0064b_04229;13667;13726;59
ESCO.0722.00357;ESCO.0722.00357.0200;ESCO.0722.00357.0200b_04709;3;686;683
ESCO.0722.00357;ESCO.0722.00357.0322;ESCO.0722.00357.0322b_04837;1;228;227
ESCO.0722.00357;ESCO.0722.00357.0359;ESCO.0722.00357.0359b_04869;2;223;221
ESCO.0722.00357;ESCO.0722.00357.0405;ESCO.0722.00357.0405b_04901;2;145;143
ESCO.0722.00357;ESCO.0722.00357.0474;ESCO.0722.00357.0474b_04933;2;61;59
ESCO.0722.00357;ESCO.0722.00357.0036;ESCO.0722.00357.0036i_03366;43787;44341;554
ESCO.0722.00357;ESCO.0722.00357.0055;ESCO.0722.00357.0055i_04070;12047;13177;1130
ESCO.0722.00357;ESCO.0722.00357.0062;ESCO.0722.00357.0062b_04198;14805;15587;782
ESCO.0722.00357;ESCO.0722.00357.0065;ESCO.0722.00357.0065b_04230;3;155;152
ESCO.0722.00357;ESCO.0722.00357.0165;ESCO.0722.00357.0165b_04646;180;626;446
ESCO.0722.00357;ESCO.0722.00357.0201;ESCO.0722.00357.0201b_04710;3;686;683
ESCO.0722.00357;ESCO.0722.00357.0287;ESCO.0722.00357.0287b_04806;2;307;305
ESCO.0722.00357;ESCO.0722.00357.0477;ESCO.0722.00357.0477b_04934;2;106;104
ESCO.0722.00357;ESCO.0722.00357.0036;ESCO.0722.00357.0036i_03367;44390;44842;452
ESCO.0722.00357;ESCO.0722.00357.0051;ESCO.0722.00357.0051b_03911;2;172;170
ESCO.0722.00357;ESCO.0722.00357.0055;ESCO.0722.00357.0055i_04071;13186;14280;1094
ESCO.0722.00357;ESCO.0722.00357.0063;ESCO.0722.00357.0063b_04199;124;789;665
ESCO.0722.00357;ESCO.0722.00357.0096;ESCO.0722.00357.0096b_04455;2;64;62
ESCO.0722.00357;ESCO.0722.00357.0123;ESCO.0722.00357.0123b_04551;3;965;962
ESCO.0722.00357;ESCO.0722.00357.0136;ESCO.0722.00357.0136b_04583;336;716;380
ESCO.0722.00357;ESCO.0722.00357.0362;ESCO.0722.00357.0362b_04871;88;219;131
ESCO.0722.00357;ESCO.0722.00357.0478;ESCO.0722.00357.0478b_04935;3;77;74
ESCO.0722.00357;ESCO.0722.00357.0007;ESCO.0722.00357.0007i_00923;12195;12428;233
ESCO.0722.00357;ESCO.0722.00357.0070;ESCO.0722.00357.0070b_04283;1;282;281
ESCO.0722.00357;ESCO.0722.00357.0093;ESCO.0722.00357.0093i_04443;964;1701;737
ESCO.0722.00357;ESCO.0722.00357.0108;ESCO.0722.00357.0108b_04507;1011;2711;1700
ESCO.0722.00357;ESCO.0722.00357.0119;ESCO.0722.00357.0119b_04539;2222;2683;461
ESCO.0722.00357;ESCO.0722.00357.0245;ESCO.0722.00357.0245b_04763;3;443;440
ESCO.0722.00357;ESCO.0722.00357.0277;ESCO.0722.00357.0277b_04795;2;340;338
ESCO.0722.00357;ESCO.0722.00357.0518;ESCO.0722.00357.0518b_04955;1;69;68
ESCO.0722.00357;ESCO.0722.00357.0007;ESCO.0722.00357.0007i_00924;12418;12681;263
ESCO.0722.00357;ESCO.0722.00357.0036;ESCO.0722.00357.0036i_03356;35328;35666;338
ESCO.0722.00357;ESCO.0722.00357.0093;ESCO.0722.00357.0093i_04444;1719;4172;2453
ESCO.0722.00357;ESCO.0722.00357.0120;ESCO.0722.00357.0120b_04540;2;268;266
ESCO.0722.00357;ESCO.0722.00357.0218;ESCO.0722.00357.0218b_04732;1;579;578
ESCO.0722.00357;ESCO.0722.00357.0246;ESCO.0722.00357.0246b_04764;107;439;332
ESCO.0722.00357;ESCO.0722.00357.0521;ESCO.0722.00357.0521b_04956;3;68;65
ESCO.0722.00357;ESCO.0722.00357.0052;ESCO.0722.00357.0052i_03988;22209;22481;272
ESCO.0722.00357;ESCO.0722.00357.0304;ESCO.0722.00357.0304b_04820;2;268;266
ESCO.0722.00357;ESCO.0722.00357.0506;ESCO.0722.00357.0506b_04948;1;81;80
ESCO.0722.00357;ESCO.0722.00357.0028;ESCO.0722.00357.0028b_03086;2;385;383
ESCO.0722.00357;ESCO.0722.00357.0090;ESCO.0722.00357.0090i_04430;2300;3016;716
ESCO.0722.00357;ESCO.0722.00357.0233;ESCO.0722.00357.0233b_04750;208;471;263
ESCO.0722.00357;ESCO.0722.00357.0265;ESCO.0722.00357.0265b_04782;3;200;197
ESCO.0722.00357;ESCO.0722.00357.0426;ESCO.0722.00357.0426b_04910;1;123;122
ESCO.0722.00357;ESCO.0722.00357.0035;ESCO.0722.00357.0035i_03279;13687;14199;512
ESCO.0722.00357;ESCO.0722.00357.0065;ESCO.0722.00357.0065i_04239;8991;9701;710
ESCO.0722.00357;ESCO.0722.00357.0076;ESCO.0722.00357.0076b_04335;5359;8223;2864
ESCO.0722.00357;ESCO.0722.00357.0090;ESCO.0722.00357.0090i_04431;3074;3646;572
ESCO.0722.00357;ESCO.0722.00357.0126;ESCO.0722.00357.0126b_04559;1651;2274;623
ESCO.0722.00357;ESCO.0722.00357.0139;ESCO.0722.00357.0139b_04591;1762;1899;137
ESCO.0722.00357;ESCO.0722.00357.0152;ESCO.0722.00357.0152b_04623;1326;1421;95
ESCO.0722.00357;ESCO.0722.00357.0186;ESCO.0722.00357.0186b_04687;2;295;293
ESCO.0722.00357;ESCO.0722.00357.0266;ESCO.0722.00357.0266b_04783;3;368;365
ESCO.0722.00357;ESCO.0722.00357.0297;ESCO.0722.00357.0297b_04815;2;289;287
ESCO.0722.00357;ESCO.0722.00357.0335;ESCO.0722.00357.0335b_04847;2;70;68
ESCO.0722.00357;ESCO.0722.00357.0372;ESCO.0722.00357.0372b_04879;3;197;194
ESCO.0722.00357;ESCO.0722.00357.0492;ESCO.0722.00357.0492b_04943;2;97;95
ESCO.0722.00357;ESCO.0722.00357.0035;ESCO.0722.00357.0035i_03275;9227;9733;506
ESCO.0722.00357;ESCO.0722.00357.0053;ESCO.0722.00357.0053i_04011;10404;11357;953
ESCO.0722.00357;ESCO.0722.00357.0055;ESCO.0722.00357.0055i_04075;17882;19033;1151
ESCO.0722.00357;ESCO.0722.00357.0065;ESCO.0722.00357.0065i_04235;3978;6944;2966
ESCO.0722.00357;ESCO.0722.00357.0090;ESCO.0722.00357.0090b_04427;3;359;356
ESCO.0722.00357;ESCO.0722.00357.0167;ESCO.0722.00357.0167b_04651;2;775;773
ESCO.0722.00357;ESCO.0722.00357.0183;ESCO.0722.00357.0183b_04683;1;855;854
ESCO.0722.00357;ESCO.0722.00357.0260;ESCO.0722.00357.0260b_04779;2;265;263
ESCO.0722.00357;ESCO.0722.00357.0330;ESCO.0722.00357.0330b_04843;2;244;242
ESCO.0722.00357;ESCO.0722.00357.0367;ESCO.0722.00357.0367b_04875;2;211;209
ESCO.0722.00357;ESCO.0722.00357.0418;ESCO.0722.00357.0418b_04907;2;130;128
ESCO.0722.00357;ESCO.0722.00357.0484;ESCO.0722.00357.0484b_04939;3;101;98
ESCO.0722.00357;ESCO.0722.00357.0035;ESCO.0722.00357.0035i_03276;9790;10083;293
ESCO.0722.00357;ESCO.0722.00357.0036;ESCO.0722.00357.0036i_03372;49568;49852;284
ESCO.0722.00357;ESCO.0722.00357.0065;ESCO.0722.00357.0065i_04236;6925;7548;623
ESCO.0722.00357;ESCO.0722.00357.0036;ESCO.0722.00357.0036i_03373;49845;50732;887
ESCO.0722.00357;ESCO.0722.00357.0040;ESCO.0722.00357.0040i_03501;4925;5413;488
ESCO.0722.00357;ESCO.0722.00357.0065;ESCO.0722.00357.0065i_04237;7706;8233;527
ESCO.0722.00357;ESCO.0722.00357.0076;ESCO.0722.00357.0076i_04333;4593;4955;362
ESCO.0722.00357;ESCO.0722.00357.0090;ESCO.0722.00357.0090i_04429;1184;2278;1094
ESCO.0722.00357;ESCO.0722.00357.0125;ESCO.0722.00357.0125b_04557;2;2323;2321
ESCO.0722.00357;ESCO.0722.00357.0167;ESCO.0722.00357.0167b_04653;1043;1204;161
ESCO.0722.00357;ESCO.0722.00357.0295;ESCO.0722.00357.0295b_04813;2;298;296
ESCO.0722.00357;ESCO.0722.00357.0370;ESCO.0722.00357.0370b_04877;3;209;206
ESCO.0722.00357;ESCO.0722.00357.0016;ESCO.0722.00357.0016b_02229;132782;133138;356
ESCO.0722.00357;ESCO.0722.00357.0052;ESCO.0722.00357.0052i_03989;22481;24892;2411
ESCO.0722.00357;ESCO.0722.00357.0271;ESCO.0722.00357.0271b_04789;3;350;347
ESCO.0722.00357;ESCO.0722.00357.0306;ESCO.0722.00357.0306b_04821;3;158;155
ESCO.0722.00357;ESCO.0722.00357.0006;ESCO.0722.00357.0006i_00896;264423;264584;161
ESCO.0722.00357;ESCO.0722.00357.0009;ESCO.0722.00357.0009b_01376;219380;219592;212
ESCO.0722.00357;ESCO.0722.00357.0028;ESCO.0722.00357.0028i_03104;20180;20587;407
ESCO.0722.00357;ESCO.0722.00357.0036;ESCO.0722.00357.0036i_03360;38606;39256;650
ESCO.0722.00357;ESCO.0722.00357.0043;ESCO.0722.00357.0043i_03680;39424;40689;1265
ESCO.0722.00357;ESCO.0722.00357.0089;ESCO.0722.00357.0089b_04416;2;265;263
ESCO.0722.00357;ESCO.0722.00357.0197;ESCO.0722.00357.0197b_04704;563;712;149
ESCO.0722.00357;ESCO.0722.00357.0354;ESCO.0722.00357.0354b_04864;3;227;224
ESCO.0722.00357;ESCO.0722.00357.0455;ESCO.0722.00357.0455b_04928;3;74;71
ESCO.0722.00357;ESCO.0722.00357.0006;ESCO.0722.00357.0006i_00897;264591;264953;362
ESCO.0722.00357;ESCO.0722.00357.0028;ESCO.0722.00357.0028i_03105;20633;21244;611
ESCO.0722.00357;ESCO.0722.00357.0036;ESCO.0722.00357.0036i_03361;39273;39755;482
ESCO.0722.00357;ESCO.0722.00357.0222;ESCO.0722.00357.0222b_04737;3;260;257
ESCO.0722.00357;ESCO.0722.00357.0251;ESCO.0722.00357.0251b_04769;2;115;113
ESCO.0722.00357;ESCO.0722.00357.0318;ESCO.0722.00357.0318b_04833;2;253;251
ESCO.0722.00357;ESCO.0722.00357.0011;ESCO.0722.00357.0011b_01565;212486;213175;689
ESCO.0722.00357;ESCO.0722.00357.0036;ESCO.0722.00357.0036i_03357;35659;35940;281
ESCO.0722.00357;ESCO.0722.00357.0052;ESCO.0722.00357.0052b_03965;277;678;401
ESCO.0722.00357;ESCO.0722.00357.0093;ESCO.0722.00357.0093b_04445;4247;4774;527
ESCO.0722.00357;ESCO.0722.00357.0247;ESCO.0722.00357.0247b_04765;3;440;437
ESCO.0722.00357;ESCO.0722.00357.0279;ESCO.0722.00357.0279b_04797;3;95;92
ESCO.0722.00357;ESCO.0722.00357.0012;ESCO.0722.00357.0012b_01566;2;700;698
ESCO.0722.00357;ESCO.0722.00357.0021;ESCO.0722.00357.0021b_02558;1;456;455
ESCO.0722.00357;ESCO.0722.00357.0050;ESCO.0722.00357.0050i_03902;26869;27117;248
ESCO.0722.00357;ESCO.0722.00357.0070;ESCO.0722.00357.0070b_04286;2593;3312;719
ESCO.0722.00357;ESCO.0722.00357.0094;ESCO.0722.00357.0094b_04446;79;501;422
ESCO.0722.00357;ESCO.0722.00357.0174;ESCO.0722.00357.0174b_04670;3;1082;1079
ESCO.0722.00357;ESCO.0722.00357.0220;ESCO.0722.00357.0220b_04734;410;574;164
ESCO.0722.00357;ESCO.0722.00357.0248;ESCO.0722.00357.0248b_04766;47;439;392
ESCO.0722.00357;ESCO.0722.00357.0280;ESCO.0722.00357.0280b_04798;3;326;323
ESCO.0722.00357;ESCO.0722.00357.0453;ESCO.0722.00357.0453b_04926;1;108;107
ESCO.0722.00357;ESCO.0722.00357.0009;ESCO.0722.00357.0009i_01375;218655;219356;701
ESCO.0722.00357;ESCO.0722.00357.0027;ESCO.0722.00357.0027b_03007;2;496;494
ESCO.0722.00357;ESCO.0722.00357.0036;ESCO.0722.00357.0036i_03327;7911;8477;566
ESCO.0722.00357;ESCO.0722.00357.0036;ESCO.0722.00357.0036i_03359;37362;38609;1247
ESCO.0722.00357;ESCO.0722.00357.0050;ESCO.0722.00357.0050i_03903;27139;27891;752
ESCO.0722.00357;ESCO.0722.00357.0071;ESCO.0722.00357.0071b_04287;3;662;659
ESCO.0722.00357;ESCO.0722.00357.0094;ESCO.0722.00357.0094b_04447;624;4757;4133
ESCO.0722.00357;ESCO.0722.00357.0101;ESCO.0722.00357.0101b_04479;3;584;581
ESCO.0722.00357;ESCO.0722.00357.0249;ESCO.0722.00357.0249b_04767;1;429;428
ESCO.0722.00357;ESCO.0722.00357.0353;ESCO.0722.00357.0353b_04863;3;227;224
ESCO.0722.00357;ESCO.0722.00357.0399;ESCO.0722.00357.0399b_04895;3;161;158
ESCO.0722.00357;ESCO.0722.00357.0526;ESCO.0722.00357.0526b_04959;2;64;62
ESCO.0722.00357;ESCO.0722.00357.0055;ESCO.0722.00357.0055i_04072;14295;15473;1178
ESCO.0722.00357;ESCO.0722.00357.0071;ESCO.0722.00357.0071b_04296;5812;5982;170
ESCO.0722.00357;ESCO.0722.00357.0123;ESCO.0722.00357.0123i_04552;1559;2152;593
ESCO.0722.00357;ESCO.0722.00357.0136;ESCO.0722.00357.0136b_04584;713;1753;1040
ESCO.0722.00357;ESCO.0722.00357.0150;ESCO.0722.00357.0150b_04616;1;426;425
ESCO.0722.00357;ESCO.0722.00357.0325;ESCO.0722.00357.0325b_04840;1;246;245
ESCO.0722.00357;ESCO.0722.00357.0038;ESCO.0722.00357.0038b_03465;24516;24632;116
ESCO.0722.00357;ESCO.0722.00357.0055;ESCO.0722.00357.0055i_04073;15493;16767;1274
ESCO.0722.00357;ESCO.0722.00357.0065;ESCO.0722.00357.0065i_04233;2840;3832;992
ESCO.0722.00357;ESCO.0722.00357.0072;ESCO.0722.00357.0072b_04297;1;2037;2036
ESCO.0722.00357;ESCO.0722.00357.0123;ESCO.0722.00357.0123b_04553;2281;2454;173
ESCO.0722.00357;ESCO.0722.00357.0204;ESCO.0722.00357.0204b_04713;3;662;659
ESCO.0722.00357;ESCO.0722.00357.0258;ESCO.0722.00357.0258b_04777;1;246;245
ESCO.0722.00357;ESCO.0722.00357.0364;ESCO.0722.00357.0364b_04873;3;215;212
ESCO.0722.00357;ESCO.0722.00357.0039;ESCO.0722.00357.0039b_03466;1;126;125
ESCO.0722.00357;ESCO.0722.00357.0053;ESCO.0722.00357.0053i_04010;9656;10465;809
ESCO.0722.00357;ESCO.0722.00357.0055;ESCO.0722.00357.0055i_04074;16788;17261;473
ESCO.0722.00357;ESCO.0722.00357.0065;ESCO.0722.00357.0065i_04234;3829;3939;110
ESCO.0722.00357;ESCO.0722.00357.0205;ESCO.0722.00357.0205b_04714;8;661;653
ESCO.0722.00357;ESCO.0722.00357.0365;ESCO.0722.00357.0365b_04874;3;65;62
ESCO.0722.00357;ESCO.0722.00357.0059;ESCO.0722.00357.0059i_04147;6498;6989;491
ESCO.0722.00357;ESCO.0722.00357.0169;ESCO.0722.00357.0169b_04659;891;1187;296
ESCO.0722.00357;ESCO.0722.00357.0237;ESCO.0722.00357.0237b_04755;2;241;239
ESCO.0722.00357;ESCO.0722.00357.0302;ESCO.0722.00357.0302b_04819;2;271;269
ESCO.0722.00357;ESCO.0722.00357.0378;ESCO.0722.00357.0378b_04883;3;203;200
ESCO.0722.00357;ESCO.0722.00357.0433;ESCO.0722.00357.0433b_04915;1;117;116
ESCO.0722.00357;ESCO.0722.00357.0036;ESCO.0722.00357.0036i_03383;58631;59017;386
ESCO.0722.00357;ESCO.0722.00357.0045;ESCO.0722.00357.0045b_03767;42131;42367;236
ESCO.0722.00357;ESCO.0722.00357.0171;ESCO.0722.00357.0171b_04663;39;626;587
ESCO.0722.00357;ESCO.0722.00357.0190;ESCO.0722.00357.0190b_04695;2;754;752
ESCO.0722.00357;ESCO.0722.00357.0273;ESCO.0722.00357.0273b_04791;2;346;344
ESCO.0722.00357;ESCO.0722.00357.0308;ESCO.0722.00357.0308b_04823;3;263;260
ESCO.0722.00357;ESCO.0722.00357.0344;ESCO.0722.00357.0344b_04855;2;232;230
ESCO.0722.00357;ESCO.0722.00357.0017;ESCO.0722.00357.0017i_02328;104902;105444;542
ESCO.0722.00357;ESCO.0722.00357.0052;ESCO.0722.00357.0052i_03992;26519;26698;179
ESCO.0722.00357;ESCO.0722.00357.0214;ESCO.0722.00357.0214b_04728;86;613;527
ESCO.0722.00357;ESCO.0722.00357.0309;ESCO.0722.00357.0309b_04824;1;264;263
ESCO.0722.00357;ESCO.0722.00357.0390;ESCO.0722.00357.0390b_04888;3;170;167
ESCO.0722.00357;ESCO.0722.00357.0515;ESCO.0722.00357.0515b_04952;1;72;71
ESCO.0722.00357;ESCO.0722.00357.0001;ESCO.0722.00357.0001i_00121;126793;127227;434
ESCO.0722.00357;ESCO.0722.00357.0004;ESCO.0722.00357.0004i_00409;55760;55900;140
ESCO.0722.00357;ESCO.0722.00357.0037;ESCO.0722.00357.0037i_03417;28130;28264;134
ESCO.0722.00357;ESCO.0722.00357.0052;ESCO.0722.00357.0052i_03993;26673;27218;545
ESCO.0722.00357;ESCO.0722.00357.0093;ESCO.0722.00357.0093b_04441;3;182;179
ESCO.0722.00357;ESCO.0722.00357.0347;ESCO.0722.00357.0347b_04857;2;232;230
ESCO.0722.00357;ESCO.0722.00357.0001;ESCO.0722.00357.0001i_00122;127234;127455;221
ESCO.0722.00357;ESCO.0722.00357.0037;ESCO.0722.00357.0037b_03386;109;282;173
ESCO.0722.00357;ESCO.0722.00357.0069;ESCO.0722.00357.0069b_04282;11204;11452;248
ESCO.0722.00357;ESCO.0722.00357.0093;ESCO.0722.00357.0093i_04442;554;859;305
ESCO.0722.00357;ESCO.0722.00357.0130;ESCO.0722.00357.0130b_04570;3;122;119
ESCO.0722.00357;ESCO.0722.00357.0193;ESCO.0722.00357.0193b_04698;135;710;575
ESCO.0722.00357;ESCO.0722.00357.0244;ESCO.0722.00357.0244b_04762;3;443;440
ESCO.0722.00357;ESCO.0722.00357.0276;ESCO.0722.00357.0276b_04794;1;273;272
ESCO.0722.00357;ESCO.0722.00357.0445;ESCO.0722.00357.0445b_04922;1;111;110
ESCO.0722.00357;ESCO.0722.00357.0055;ESCO.0722.00357.0055i_04066;6452;6886;434
ESCO.0722.00357;ESCO.0722.00357.0111;ESCO.0722.00357.0111b_04514;2;250;248
ESCO.0722.00357;ESCO.0722.00357.0251;ESCO.0722.00357.0251b_04770;102;359;257
ESCO.0722.00357;ESCO.0722.00357.0319;ESCO.0722.00357.0319b_04834;2;253;251
ESCO.0722.00357;ESCO.0722.00357.0402;ESCO.0722.00357.0402b_04898;2;148;146
ESCO.0722.00357;ESCO.0722.00357.0467;ESCO.0722.00357.0467b_04930;1;108;107
ESCO.0722.00357;ESCO.0722.00357.0036;ESCO.0722.00357.0036i_03331;10229;10390;161
ESCO.0722.00357;ESCO.0722.00357.0055;ESCO.0722.00357.0055i_04067;6903;9065;2162
ESCO.0722.00357;ESCO.0722.00357.0057;ESCO.0722.00357.0057b_04099;3;227;224
ESCO.0722.00357;ESCO.0722.00357.0121;ESCO.0722.00357.0121b_04547;2;1822;1820
ESCO.0722.00357;ESCO.0722.00357.0148;ESCO.0722.00357.0148b_04611;2;139;137
ESCO.0722.00357;ESCO.0722.00357.0163;ESCO.0722.00357.0163b_04643;2;370;368
ESCO.0722.00357;ESCO.0722.00357.0178;ESCO.0722.00357.0178b_04675;47;688;641
ESCO.0722.00357;ESCO.0722.00357.0199;ESCO.0722.00357.0199b_04707;3;161;158
ESCO.0722.00357;ESCO.0722.00357.0320;ESCO.0722.00357.0320b_04835;8;253;245
ESCO.0722.00357;ESCO.0722.00357.0403;ESCO.0722.00357.0403b_04899;1;147;146
ESCO.0722.00357;ESCO.0722.00357.0469;ESCO.0722.00357.0469b_04931;1;108;107
ESCO.0722.00357;ESCO.0722.00357.0036;ESCO.0722.00357.0036i_03332;10546;11046;500
ESCO.0722.00357;ESCO.0722.00357.0050;ESCO.0722.00357.0050i_03876;1148;1654;506
ESCO.0722.00357;ESCO.0722.00357.0055;ESCO.0722.00357.0055i_04068;9137;10567;1430
ESCO.0722.00357;ESCO.0722.00357.0084;ESCO.0722.00357.0084b_04388;70;711;641
ESCO.0722.00357;ESCO.0722.00357.0178;ESCO.0722.00357.0178b_04676;843;1010;167
ESCO.0722.00357;ESCO.0722.00357.0199;ESCO.0722.00357.0199b_04708;118;711;593
ESCO.0722.00357;ESCO.0722.00357.0358;ESCO.0722.00357.0358b_04868;3;224;221
ESCO.0722.00357;ESCO.0722.00357.0404;ESCO.0722.00357.0404b_04900;2;130;128
ESCO.0722.00357;ESCO.0722.00357.0055;ESCO.0722.00357.0055b_04080;25894;26898;1004
ESCO.0722.00357;ESCO.0722.00357.0065;ESCO.0722.00357.0065i_04240;9739;10353;614
ESCO.0722.00357;ESCO.0722.00357.0077;ESCO.0722.00357.0077b_04336;80;976;896
ESCO.0722.00357;ESCO.0722.00357.0090;ESCO.0722.00357.0090b_04432;3653;4603;950
ESCO.0722.00357;ESCO.0722.00357.0140;ESCO.0722.00357.0140b_04592;48;254;206
ESCO.0722.00357;ESCO.0722.00357.0235;ESCO.0722.00357.0235b_04752;3;464;461
ESCO.0722.00357;ESCO.0722.00357.0335;ESCO.0722.00357.0335b_04848;70;243;173
ESCO.0722.00357;ESCO.0722.00357.0373;ESCO.0722.00357.0373b_04880;75;206;131
ESCO.0722.00357;ESCO.0722.00357.0429;ESCO.0722.00357.0429b_04912;2;97;95
ESCO.0722.00357;ESCO.0722.00357.0496;ESCO.0722.00357.0496b_04944;16;90;74
ESCO.0722.00357;ESCO.0722.00357.0011;ESCO.0722.00357.0011i_01489;126931;127740;809
ESCO.0722.00357;ESCO.0722.00357.0045;ESCO.0722.00357.0045b_03729;1;2313;2312
ESCO.0722.00357;ESCO.0722.00357.0057;ESCO.0722.00357.0057b_04113;20504;21580;1076
ESCO.0722.00357;ESCO.0722.00357.0065;ESCO.0722.00357.0065i_04241;10522;11289;767
ESCO.0722.00357;ESCO.0722.00357.0127;ESCO.0722.00357.0127i_04561;504;1157;653
ESCO.0722.00357;ESCO.0722.00357.0169;ESCO.0722.00357.0169b_04657;62;355;293
ESCO.0722.00357;ESCO.0722.00357.0187;ESCO.0722.00357.0187b_04689;30;518;488
ESCO.0722.00357;ESCO.0722.00357.0299;ESCO.0722.00357.0299b_04817;30;287;257
ESCO.0722.00357;ESCO.0722.00357.0374;ESCO.0722.00357.0374b_04881;2;205;203
ESCO.0722.00357;ESCO.0722.00357.0498;ESCO.0722.00357.0498b_04945;2;88;86
ESCO.0722.00357;ESCO.0722.00357.0006;ESCO.0722.00357.0006b_00626;1;267;266
ESCO.0722.00357;ESCO.0722.00357.0065;ESCO.0722.00357.0065b_04242;11475;13133;1658
ESCO.0722.00357;ESCO.0722.00357.0169;ESCO.0722.00357.0169i_04658;352;888;536
ESCO.0722.00357;ESCO.0722.00357.0211;ESCO.0722.00357.0211b_04722;3;416;413
ESCO.0722.00357;ESCO.0722.00357.0268;ESCO.0722.00357.0268b_04786;3;83;80
ESCO.0722.00357;ESCO.0722.00357.0301;ESCO.0722.00357.0301b_04818;192;281;89
ESCO.0722.00357;ESCO.0722.00357.0431;ESCO.0722.00357.0431b_04914;3;119;116
ESCO.0722.00359;ESCO.0722.00359.0001;ESCO.0722.00359.0001i_00343;397780;398814;1034
ESCO.0722.00359;ESCO.0722.00359.0017;ESCO.0722.00359.0017i_02679;33327;33653;326
ESCO.0722.00359;ESCO.0722.00359.0043;ESCO.0722.00359.0043i_04343;3048;8006;4958
ESCO.0722.00359;ESCO.0722.00359.0046;ESCO.0722.00359.0046b_04407;1;87;86
ESCO.0722.00359;ESCO.0722.00359.0055;ESCO.0722.00359.0055b_04503;102;1193;1091
ESCO.0722.00359;ESCO.0722.00359.0184;ESCO.0722.00359.0184b_04855;417;575;158
ESCO.0722.00359;ESCO.0722.00359.0238;ESCO.0722.00359.0238b_04919;2;463;461
ESCO.0722.00359;ESCO.0722.00359.0300;ESCO.0722.00359.0300b_04983;2;145;143
ESCO.0722.00359;ESCO.0722.00359.0330;ESCO.0722.00359.0330b_05015;57;380;323
ESCO.0722.00359;ESCO.0722.00359.0360;ESCO.0722.00359.0360b_05047;2;361;359
ESCO.0722.00359;ESCO.0722.00359.0388;ESCO.0722.00359.0388b_05079;2;346;344
ESCO.0722.00359;ESCO.0722.00359.0420;ESCO.0722.00359.0420b_05111;1;336;335
ESCO.0722.00359;ESCO.0722.00359.0452;ESCO.0722.00359.0452b_05143;1;321;320
ESCO.0722.00359;ESCO.0722.00359.0488;ESCO.0722.00359.0488b_05175;160;306;146
ESCO.0722.00359;ESCO.0722.00359.0524;ESCO.0722.00359.0524b_05207;2;295;293
ESCO.0722.00359;ESCO.0722.00359.0556;ESCO.0722.00359.0556b_05239;193;288;95
ESCO.0722.00359;ESCO.0722.00359.0621;ESCO.0722.00359.0621b_05303;2;271;269
ESCO.0722.00359;ESCO.0722.00359.0692;ESCO.0722.00359.0692b_05367;1;261;260
ESCO.0722.00359;ESCO.0722.00359.0728;ESCO.0722.00359.0728b_05399;2;259;257
ESCO.0722.00359;ESCO.0722.00359.0760;ESCO.0722.00359.0760b_05431;2;253;251
ESCO.0722.00359;ESCO.0722.00359.0797;ESCO.0722.00359.0797b_05463;2;205;203
ESCO.0722.00359;ESCO.0722.00359.0835;ESCO.0722.00359.0835b_05495;30;245;215
ESCO.0722.00359;ESCO.0722.00359.0867;ESCO.0722.00359.0867b_05527;3;242;239
ESCO.0722.00359;ESCO.0722.00359.0904;ESCO.0722.00359.0904b_05559;1;240;239
ESCO.0722.00359;ESCO.0722.00359.0973;ESCO.0722.00359.0973b_05623;3;233;230
ESCO.0722.00359;ESCO.0722.00359.1007;ESCO.0722.00359.1007b_05655;3;230;227
ESCO.0722.00359;ESCO.0722.00359.1043;ESCO.0722.00359.1043b_05687;3;227;224
ESCO.0722.00359;ESCO.0722.00359.1082;ESCO.0722.00359.1082b_05719;1;225;224
ESCO.0722.00359;ESCO.0722.00359.1118;ESCO.0722.00359.1118b_05751;1;222;221
ESCO.0722.00359;ESCO.0722.00359.1154;ESCO.0722.00359.1154b_05783;155;220;65
ESCO.0722.00359;ESCO.0722.00359.1190;ESCO.0722.00359.1190b_05815;3;218;215
ESCO.0722.00359;ESCO.0722.00359.1226;ESCO.0722.00359.1226b_05847;3;215;212
ESCO.0722.00359;ESCO.0722.00359.1260;ESCO.0722.00359.1260b_05879;2;211;209
ESCO.0722.00359;ESCO.0722.00359.1293;ESCO.0722.00359.1293b_05911;1;210;209
ESCO.0722.00359;ESCO.0722.00359.1331;ESCO.0722.00359.1331b_05943;2;205;203
ESCO.0722.00359;ESCO.0722.00359.0024;ESCO.0722.00359.0024i_03046;61563;62519;956
ESCO.0722.00359;ESCO.0722.00359.0032;ESCO.0722.00359.0032b_04006;103851;104096;245
ESCO.0722.00359;ESCO.0722.00359.0037;ESCO.0722.00359.0037i_04230;25198;25677;479
ESCO.0722.00359;ESCO.0722.00359.0131;ESCO.0722.00359.0131b_04774;3;473;470
ESCO.0722.00359;ESCO.0722.00359.0172;ESCO.0722.00359.0172b_04838;1;621;620
ESCO.0722.00359;ESCO.0722.00359.0281;ESCO.0722.00359.0281b_04966;2;418;416
ESCO.0722.00359;ESCO.0722.00359.0312;ESCO.0722.00359.0312b_04998;1;69;68
ESCO.0722.00359;ESCO.0722.00359.0373;ESCO.0722.00359.0373b_05062;3;272;269
ESCO.0722.00359;ESCO.0722.00359.0399;ESCO.0722.00359.0399b_05094;3;299;296
ESCO.0722.00359;ESCO.0722.00359.0435;ESCO.0722.00359.0435b_05126;149;331;182
ESCO.0722.00359;ESCO.0722.00359.0468;ESCO.0722.00359.0468b_05158;3;314;311
ESCO.0722.00359;ESCO.0722.00359.0503;ESCO.0722.00359.0503b_05190;100;300;200
ESCO.0722.00359;ESCO.0722.00359.0539;ESCO.0722.00359.0539b_05222;3;293;290
ESCO.0722.00359;ESCO.0722.00359.0570;ESCO.0722.00359.0570b_05254;2;283;281
ESCO.0722.00359;ESCO.0722.00359.0603;ESCO.0722.00359.0603b_05286;1;273;272
ESCO.0722.00359;ESCO.0722.00359.0640;ESCO.0722.00359.0640b_05318;3;269;266
ESCO.0722.00359;ESCO.0722.00359.0674;ESCO.0722.00359.0674b_05350;2;262;260
ESCO.0722.00359;ESCO.0722.00359.0710;ESCO.0722.00359.0710b_05382;2;259;257
ESCO.0722.00359;ESCO.0722.00359.0743;ESCO.0722.00359.0743b_05414;1;255;254
ESCO.0722.00359;ESCO.0722.00359.0777;ESCO.0722.00359.0777b_05446;3;251;248
ESCO.0722.00359;ESCO.0722.00359.0815;ESCO.0722.00359.0815b_05478;3;248;245
ESCO.0722.00359;ESCO.0722.00359.0850;ESCO.0722.00359.0850b_05510;2;244;242
ESCO.0722.00359;ESCO.0722.00359.0887;ESCO.0722.00359.0887b_05542;3;242;239
ESCO.0722.00359;ESCO.0722.00359.0920;ESCO.0722.00359.0920b_05574;3;239;236
ESCO.0722.00359;ESCO.0722.00359.0956;ESCO.0722.00359.0956b_05606;2;235;233
ESCO.0722.00359;ESCO.0722.00359.0989;ESCO.0722.00359.0989b_05638;2;232;230
ESCO.0722.00359;ESCO.0722.00359.1025;ESCO.0722.00359.1025b_05670;1;228;227
ESCO.0722.00359;ESCO.0722.00359.1064;ESCO.0722.00359.1064b_05702;3;227;224
ESCO.0722.00359;ESCO.0722.00359.1098;ESCO.0722.00359.1098b_05734;2;115;113
ESCO.0722.00359;ESCO.0722.00359.1172;ESCO.0722.00359.1172b_05798;2;217;215
ESCO.0722.00359;ESCO.0722.00359.1209;ESCO.0722.00359.1209b_05830;1;174;173
ESCO.0722.00359;ESCO.0722.00359.1241;ESCO.0722.00359.1241b_05862;76;213;137
ESCO.0722.00359;ESCO.0722.00359.1275;ESCO.0722.00359.1275b_05894;3;179;176
ESCO.0722.00359;ESCO.0722.00359.1310;ESCO.0722.00359.1310b_05926;114;209;95
ESCO.0722.00359;ESCO.0722.00359.1347;ESCO.0722.00359.1347b_05958;1;114;113
ESCO.0722.00359;ESCO.0722.00359.0024;ESCO.0722.00359.0024i_03047;62532;62969;437
ESCO.0722.00359;ESCO.0722.00359.0037;ESCO.0722.00359.0037i_04231;25620;26504;884
ESCO.0722.00359;ESCO.0722.00359.0100;ESCO.0722.00359.0100b_04711;2;340;338
ESCO.0722.00359;ESCO.0722.00359.0149;ESCO.0722.00359.0149b_04807;2;856;854
ESCO.0722.00359;ESCO.0722.00359.0198;ESCO.0722.00359.0198b_04871;331;543;212
ESCO.0722.00359;ESCO.0722.00359.0226;ESCO.0722.00359.0226b_04903;1;417;416
ESCO.0722.00359;ESCO.0722.00359.0256;ESCO.0722.00359.0256b_04935;3;446;443
ESCO.0722.00359;ESCO.0722.00359.0282;ESCO.0722.00359.0282b_04967;2;94;92
ESCO.0722.00359;ESCO.0722.00359.0374;ESCO.0722.00359.0374b_05063;3;356;353
ESCO.0722.00359;ESCO.0722.00359.0436;ESCO.0722.00359.0436b_05127;2;73;71
ESCO.0722.00359;ESCO.0722.00359.0469;ESCO.0722.00359.0469b_05159;2;181;179
ESCO.0722.00359;ESCO.0722.00359.0504;ESCO.0722.00359.0504b_05191;3;299;296
ESCO.0722.00359;ESCO.0722.00359.0540;ESCO.0722.00359.0540b_05223;1;291;290
ESCO.0722.00359;ESCO.0722.00359.0572;ESCO.0722.00359.0572b_05255;143;283;140
ESCO.0722.00359;ESCO.0722.00359.0604;ESCO.0722.00359.0604b_05287;1;273;272
ESCO.0722.00359;ESCO.0722.00359.0641;ESCO.0722.00359.0641b_05319;2;223;221
ESCO.0722.00359;ESCO.0722.00359.0675;ESCO.0722.00359.0675b_05351;2;262;260
ESCO.0722.00359;ESCO.0722.00359.0711;ESCO.0722.00359.0711b_05383;3;260;257
ESCO.0722.00359;ESCO.0722.00359.0744;ESCO.0722.00359.0744b_05415;1;255;254
ESCO.0722.00359;ESCO.0722.00359.0778;ESCO.0722.00359.0778b_05447;3;251;248
ESCO.0722.00359;ESCO.0722.00359.0816;ESCO.0722.00359.0816b_05479;3;248;245
ESCO.0722.00359;ESCO.0722.00359.0851;ESCO.0722.00359.0851b_05511;3;245;242
ESCO.0722.00359;ESCO.0722.00359.0888;ESCO.0722.00359.0888b_05543;1;240;239
ESCO.0722.00359;ESCO.0722.00359.0921;ESCO.0722.00359.0921b_05575;3;239;236
ESCO.0722.00359;ESCO.0722.00359.0957;ESCO.0722.00359.0957b_05607;3;236;233
ESCO.0722.00359;ESCO.0722.00359.0990;ESCO.0722.00359.0990b_05639;87;233;146
ESCO.0722.00359;ESCO.0722.00359.1026;ESCO.0722.00359.1026b_05671;2;229;227
ESCO.0722.00359;ESCO.0722.00359.1066;ESCO.0722.00359.1066b_05703;2;226;224
ESCO.0722.00359;ESCO.0722.00359.1099;ESCO.0722.00359.1099b_05735;3;224;221
ESCO.0722.00359;ESCO.0722.00359.1135;ESCO.0722.00359.1135b_05767;3;221;218
ESCO.0722.00359;ESCO.0722.00359.1173;ESCO.0722.00359.1173b_05799;3;218;215
ESCO.0722.00359;ESCO.0722.00359.1210;ESCO.0722.00359.1210b_05831;2;214;212
ESCO.0722.00359;ESCO.0722.00359.1242;ESCO.0722.00359.1242b_05863;2;214;212
ESCO.0722.00359;ESCO.0722.00359.1276;ESCO.0722.00359.1276b_05895;14;211;197
ESCO.0722.00359;ESCO.0722.00359.1311;ESCO.0722.00359.1311b_05927;3;209;206
ESCO.0722.00359;ESCO.0722.00359.1348;ESCO.0722.00359.1348b_05959;3;206;203
ESCO.0722.00359;ESCO.0722.00359.1392;ESCO.0722.00359.1392b_05991;3;110;107
ESCO.0722.00359;ESCO.0722.00359.0011;ESCO.0722.00359.0011i_01832;135202;135456;254
ESCO.0722.00359;ESCO.0722.00359.0034;ESCO.0722.00359.0034i_04136;35244;35945;701
ESCO.0722.00359;ESCO.0722.00359.0075;ESCO.0722.00359.0075i_04616;1182;1685;503
ESCO.0722.00359;ESCO.0722.00359.0116;ESCO.0722.00359.0116b_04744;431;1252;821
ESCO.0722.00359;ESCO.0722.00359.0174;ESCO.0722.00359.0174b_04840;1;147;146
ESCO.0722.00359;ESCO.0722.00359.0199;ESCO.0722.00359.0199b_04872;3;389;386
ESCO.0722.00359;ESCO.0722.00359.0227;ESCO.0722.00359.0227b_04904;2;343;341
ESCO.0722.00359;ESCO.0722.00359.0257;ESCO.0722.00359.0257b_04936;3;263;260
ESCO.0722.00359;ESCO.0722.00359.0282;ESCO.0722.00359.0282b_04968;151;417;266
ESCO.0722.00359;ESCO.0722.00359.0313;ESCO.0722.00359.0313b_05000;117;374;257
ESCO.0722.00359;ESCO.0722.00359.0347;ESCO.0722.00359.0347b_05032;3;365;362
ESCO.0722.00359;ESCO.0722.00359.0375;ESCO.0722.00359.0375b_05064;3;356;353
ESCO.0722.00359;ESCO.0722.00359.0437;ESCO.0722.00359.0437b_05128;199;330;131
ESCO.0722.00359;ESCO.0722.00359.0469;ESCO.0722.00359.0469b_05160;181;312;131
ESCO.0722.00359;ESCO.0722.00359.0505;ESCO.0722.00359.0505b_05192;3;299;296
ESCO.0722.00359;ESCO.0722.00359.0541;ESCO.0722.00359.0541b_05224;3;122;119
ESCO.0722.00359;ESCO.0722.00359.0573;ESCO.0722.00359.0573b_05256;1;285;284
ESCO.0722.00359;ESCO.0722.00359.0605;ESCO.0722.00359.0605b_05288;168;272;104
ESCO.0722.00359;ESCO.0722.00359.0642;ESCO.0722.00359.0642b_05320;2;184;182
ESCO.0722.00359;ESCO.0722.00359.0676;ESCO.0722.00359.0676b_05352;3;263;260
ESCO.0722.00359;ESCO.0722.00359.0712;ESCO.0722.00359.0712b_05384;165;260;95
ESCO.0722.00359;ESCO.0722.00359.0745;ESCO.0722.00359.0745b_05416;97;255;158
ESCO.0722.00359;ESCO.0722.00359.0780;ESCO.0722.00359.0780b_05448;1;198;197
ESCO.0722.00359;ESCO.0722.00359.0818;ESCO.0722.00359.0818b_05480;3;248;245
ESCO.0722.00359;ESCO.0722.00359.0852;ESCO.0722.00359.0852b_05512;2;244;242
ESCO.0722.00359;ESCO.0722.00359.0889;ESCO.0722.00359.0889b_05544;174;242;68
ESCO.0722.00359;ESCO.0722.00359.0922;ESCO.0722.00359.0922b_05576;2;238;236
ESCO.0722.00359;ESCO.0722.00359.0958;ESCO.0722.00359.0958b_05608;3;236;233
ESCO.0722.00359;ESCO.0722.00359.0991;ESCO.0722.00359.0991b_05640;2;232;230
ESCO.0722.00359;ESCO.0722.00359.1027;ESCO.0722.00359.1027b_05672;3;230;227
ESCO.0722.00359;ESCO.0722.00359.1067;ESCO.0722.00359.1067b_05704;2;82;80
ESCO.0722.00359;ESCO.0722.00359.1101;ESCO.0722.00359.1101b_05736;3;170;167
ESCO.0722.00359;ESCO.0722.00359.1136;ESCO.0722.00359.1136b_05768;54;221;167
ESCO.0722.00359;ESCO.0722.00359.1174;ESCO.0722.00359.1174b_05800;2;217;215
ESCO.0722.00359;ESCO.0722.00359.1211;ESCO.0722.00359.1211b_05832;3;188;185
ESCO.0722.00359;ESCO.0722.00359.1277;ESCO.0722.00359.1277b_05896;1;210;209
ESCO.0722.00359;ESCO.0722.00359.1312;ESCO.0722.00359.1312b_05928;3;209;206
ESCO.0722.00359;ESCO.0722.00359.1349;ESCO.0722.00359.1349b_05960;3;206;203
ESCO.0722.00359;ESCO.0722.00359.0001;ESCO.0722.00359.0001i_00252;290947;292500;1553
ESCO.0722.00359;ESCO.0722.00359.0017;ESCO.0722.00359.0017i_02684;36729;36962;233
ESCO.0722.00359;ESCO.0722.00359.0024;ESCO.0722.00359.0024i_03004;8430;8720;290
ESCO.0722.00359;ESCO.0722.00359.0034;ESCO.0722.00359.0034i_04092;9309;9449;140
ESCO.0722.00359;ESCO.0722.00359.0042;ESCO.0722.00359.0042b_04316;1;69;68
ESCO.0722.00359;ESCO.0722.00359.0043;ESCO.0722.00359.0043i_04348;10250;10813;563
ESCO.0722.00359;ESCO.0722.00359.0044;ESCO.0722.00359.0044i_04380;13120;15384;2264
ESCO.0722.00359;ESCO.0722.00359.0048;ESCO.0722.00359.0048i_04444;8093;9391;1298
ESCO.0722.00359;ESCO.0722.00359.0142;ESCO.0722.00359.0142b_04796;819;929;110
ESCO.0722.00359;ESCO.0722.00359.0189;ESCO.0722.00359.0189b_04860;1;123;122
ESCO.0722.00359;ESCO.0722.00359.0216;ESCO.0722.00359.0216b_04892;3;290;287
ESCO.0722.00359;ESCO.0722.00359.0243;ESCO.0722.00359.0243b_04924;80;457;377
ESCO.0722.00359;ESCO.0722.00359.0274;ESCO.0722.00359.0274b_04956;2;286;284
ESCO.0722.00359;ESCO.0722.00359.0303;ESCO.0722.00359.0303b_04988;3;332;329
ESCO.0722.00359;ESCO.0722.00359.0335;ESCO.0722.00359.0335b_05020;3;377;374
ESCO.0722.00359;ESCO.0722.00359.0392;ESCO.0722.00359.0392b_05084;2;346;344
ESCO.0722.00359;ESCO.0722.00359.0458;ESCO.0722.00359.0458b_05148;102;320;218
ESCO.0722.00359;ESCO.0722.00359.0494;ESCO.0722.00359.0494b_05180;2;304;302
ESCO.0722.00359;ESCO.0722.00359.0530;ESCO.0722.00359.0530b_05212;1;294;293
ESCO.0722.00359;ESCO.0722.00359.0561;ESCO.0722.00359.0561b_05244;155;286;131
ESCO.0722.00359;ESCO.0722.00359.0593;ESCO.0722.00359.0593b_05276;146;277;131
ESCO.0722.00359;ESCO.0722.00359.0627;ESCO.0722.00359.0627b_05308;2;271;269
ESCO.0722.00359;ESCO.0722.00359.0663;ESCO.0722.00359.0663b_05340;2;265;263
ESCO.0722.00359;ESCO.0722.00359.0697;ESCO.0722.00359.0697b_05372;2;223;221
ESCO.0722.00359;ESCO.0722.00359.0733;ESCO.0722.00359.0733b_05404;1;144;143
ESCO.0722.00359;ESCO.0722.00359.0804;ESCO.0722.00359.0804b_05468;2;250;248
ESCO.0722.00359;ESCO.0722.00359.0840;ESCO.0722.00359.0840b_05500;2;247;245
ESCO.0722.00359;ESCO.0722.00359.0872;ESCO.0722.00359.0872b_05532;3;242;239
ESCO.0722.00359;ESCO.0722.00359.0908;ESCO.0722.00359.0908b_05564;1;240;239
ESCO.0722.00359;ESCO.0722.00359.0946;ESCO.0722.00359.0946b_05596;2;238;236
ESCO.0722.00359;ESCO.0722.00359.0978;ESCO.0722.00359.0978b_05628;3;170;167
ESCO.0722.00359;ESCO.0722.00359.1013;ESCO.0722.00359.1013b_05660;2;229;227
ESCO.0722.00359;ESCO.0722.00359.1052;ESCO.0722.00359.1052b_05692;1;228;227
ESCO.0722.00359;ESCO.0722.00359.1087;ESCO.0722.00359.1087b_05724;3;212;209
ESCO.0722.00359;ESCO.0722.00359.1123;ESCO.0722.00359.1123b_05756;2;223;221
ESCO.0722.00359;ESCO.0722.00359.1158;ESCO.0722.00359.1158b_05788;129;221;92
ESCO.0722.00359;ESCO.0722.00359.1197;ESCO.0722.00359.1197b_05820;3;215;212
ESCO.0722.00359;ESCO.0722.00359.1232;ESCO.0722.00359.1232b_05852;21;212;191
ESCO.0722.00359;ESCO.0722.00359.1265;ESCO.0722.00359.1265b_05884;1;84;83
ESCO.0722.00359;ESCO.0722.00359.1299;ESCO.0722.00359.1299b_05916;2;208;206
ESCO.0722.00359;ESCO.0722.00359.0001;ESCO.0722.00359.0001i_00253;292497;292949;452
ESCO.0722.00359;ESCO.0722.00359.0011;ESCO.0722.00359.0011i_01789;92169;92288;119
ESCO.0722.00359;ESCO.0722.00359.0034;ESCO.0722.00359.0034i_04093;9411;9593;182
ESCO.0722.00359;ESCO.0722.00359.0043;ESCO.0722.00359.0043i_04349;10910;11806;896
ESCO.0722.00359;ESCO.0722.00359.0044;ESCO.0722.00359.0044i_04381;15329;15502;173
ESCO.0722.00359;ESCO.0722.00359.0048;ESCO.0722.00359.0048i_04445;9457;10176;719
ESCO.0722.00359;ESCO.0722.00359.0065;ESCO.0722.00359.0065b_04573;113;577;464
ESCO.0722.00359;ESCO.0722.00359.0143;ESCO.0722.00359.0143b_04797;179;913;734
ESCO.0722.00359;ESCO.0722.00359.0167;ESCO.0722.00359.0167b_04829;38;667;629
ESCO.0722.00359;ESCO.0722.00359.0189;ESCO.0722.00359.0189b_04861;219;560;341
ESCO.0722.00359;ESCO.0722.00359.0217;ESCO.0722.00359.0217b_04893;3;491;488
ESCO.0722.00359;ESCO.0722.00359.0245;ESCO.0722.00359.0245b_04925;2;457;455
ESCO.0722.00359;ESCO.0722.00359.0274;ESCO.0722.00359.0274b_04957;299;421;122
ESCO.0722.00359;ESCO.0722.00359.0303;ESCO.0722.00359.0303b_04989;329;400;71
ESCO.0722.00359;ESCO.0722.00359.0336;ESCO.0722.00359.0336b_05021;2;154;152
ESCO.0722.00359;ESCO.0722.00359.0393;ESCO.0722.00359.0393b_05085;3;188;185
ESCO.0722.00359;ESCO.0722.00359.0459;ESCO.0722.00359.0459b_05149;3;320;317
ESCO.0722.00359;ESCO.0722.00359.0495;ESCO.0722.00359.0495b_05181;28;249;221
ESCO.0722.00359;ESCO.0722.00359.0531;ESCO.0722.00359.0531b_05213;2;295;293
ESCO.0722.00359;ESCO.0722.00359.0562;ESCO.0722.00359.0562b_05245;3;287;284
ESCO.0722.00359;ESCO.0722.00359.0595;ESCO.0722.00359.0595b_05277;1;276;275
ESCO.0722.00359;ESCO.0722.00359.0628;ESCO.0722.00359.0628b_05309;3;269;266
ESCO.0722.00359;ESCO.0722.00359.0665;ESCO.0722.00359.0665b_05341;2;265;263
ESCO.0722.00359;ESCO.0722.00359.0699;ESCO.0722.00359.0699b_05373;1;81;80
ESCO.0722.00359;ESCO.0722.00359.0733;ESCO.0722.00359.0733b_05405;162;257;95
ESCO.0722.00359;ESCO.0722.00359.0767;ESCO.0722.00359.0767b_05437;2;253;251
ESCO.0722.00359;ESCO.0722.00359.0805;ESCO.0722.00359.0805b_05469;1;249;248
ESCO.0722.00359;ESCO.0722.00359.0873;ESCO.0722.00359.0873b_05533;2;241;239
ESCO.0722.00359;ESCO.0722.00359.0909;ESCO.0722.00359.0909b_05565;3;239;236
ESCO.0722.00359;ESCO.0722.00359.0947;ESCO.0722.00359.0947b_05597;2;238;236
ESCO.0722.00359;ESCO.0722.00359.0979;ESCO.0722.00359.0979b_05629;3;179;176
ESCO.0722.00359;ESCO.0722.00359.1054;ESCO.0722.00359.1054b_05693;3;227;224
ESCO.0722.00359;ESCO.0722.00359.1089;ESCO.0722.00359.1089b_05725;2;223;221
ESCO.0722.00359;ESCO.0722.00359.1124;ESCO.0722.00359.1124b_05757;3;221;218
ESCO.0722.00359;ESCO.0722.00359.1159;ESCO.0722.00359.1159b_05789;3;218;215
ESCO.0722.00359;ESCO.0722.00359.1198;ESCO.0722.00359.1198b_05821;2;217;215
ESCO.0722.00359;ESCO.0722.00359.1234;ESCO.0722.00359.1234b_05853;2;214;212
ESCO.0722.00359;ESCO.0722.00359.1265;ESCO.0722.00359.1265b_05885;84;212;128
ESCO.0722.00359;ESCO.0722.00359.1300;ESCO.0722.00359.1300b_05917;1;207;206
ESCO.0722.00359;ESCO.0722.00359.1337;ESCO.0722.00359.1337b_05949;3;206;203
ESCO.0722.00359;ESCO.0722.00359.0001;ESCO.0722.00359.0001i_00341;396095;396391;296
ESCO.0722.00359;ESCO.0722.00359.0020;ESCO.0722.00359.0020i_02869;54818;55330;512
ESCO.0722.00359;ESCO.0722.00359.0039;ESCO.0722.00359.0039i_04277;21790;22218;428
ESCO.0722.00359;ESCO.0722.00359.0054;ESCO.0722.00359.0054i_04501;7713;8756;1043
ESCO.0722.00359;ESCO.0722.00359.0139;ESCO.0722.00359.0139b_04789;1;222;221
ESCO.0722.00359;ESCO.0722.00359.0161;ESCO.0722.00359.0161b_04821;1;717;716
ESCO.0722.00359;ESCO.0722.00359.0183;ESCO.0722.00359.0183b_04853;105;578;473
ESCO.0722.00359;ESCO.0722.00359.0209;ESCO.0722.00359.0209b_04885;1;522;521
ESCO.0722.00359;ESCO.0722.00359.0268;ESCO.0722.00359.0268b_04949;3;203;200
ESCO.0722.00359;ESCO.0722.00359.0298;ESCO.0722.00359.0298b_04981;1;405;404
ESCO.0722.00359;ESCO.0722.00359.0327;ESCO.0722.00359.0327b_05013;2;379;377
ESCO.0722.00359;ESCO.0722.00359.0357;ESCO.0722.00359.0357b_05045;176;361;185
ESCO.0722.00359;ESCO.0722.00359.0386;ESCO.0722.00359.0386b_05077;2;346;344
ESCO.0722.00359;ESCO.0722.00359.0417;ESCO.0722.00359.0417b_05109;1;336;335
ESCO.0722.00359;ESCO.0722.00359.0450;ESCO.0722.00359.0450b_05141;3;323;320
ESCO.0722.00359;ESCO.0722.00359.0484;ESCO.0722.00359.0484b_05173;214;306;92
ESCO.0722.00359;ESCO.0722.00359.0522;ESCO.0722.00359.0522b_05205;107;295;188
ESCO.0722.00359;ESCO.0722.00359.0555;ESCO.0722.00359.0555b_05237;1;99;98
ESCO.0722.00359;ESCO.0722.00359.0587;ESCO.0722.00359.0587b_05269;170;277;107
ESCO.0722.00359;ESCO.0722.00359.0620;ESCO.0722.00359.0620b_05301;1;156;155
ESCO.0722.00359;ESCO.0722.00359.0655;ESCO.0722.00359.0655b_05333;1;267;266
ESCO.0722.00359;ESCO.0722.00359.0726;ESCO.0722.00359.0726b_05397;111;257;146
ESCO.0722.00359;ESCO.0722.00359.0758;ESCO.0722.00359.0758b_05429;1;255;254
ESCO.0722.00359;ESCO.0722.00359.0794;ESCO.0722.00359.0794b_05461;2;250;248
ESCO.0722.00359;ESCO.0722.00359.0833;ESCO.0722.00359.0833b_05493;1;246;245
ESCO.0722.00359;ESCO.0722.00359.0865;ESCO.0722.00359.0865b_05525;3;242;239
ESCO.0722.00359;ESCO.0722.00359.0902;ESCO.0722.00359.0902b_05557;2;241;239
ESCO.0722.00359;ESCO.0722.00359.0938;ESCO.0722.00359.0938b_05589;1;237;236
ESCO.0722.00359;ESCO.0722.00359.0971;ESCO.0722.00359.0971b_05621;3;233;230
ESCO.0722.00359;ESCO.0722.00359.1004;ESCO.0722.00359.1004b_05653;3;230;227
ESCO.0722.00359;ESCO.0722.00359.1080;ESCO.0722.00359.1080b_05717;3;224;221
ESCO.0722.00359;ESCO.0722.00359.1116;ESCO.0722.00359.1116b_05749;1;222;221
ESCO.0722.00359;ESCO.0722.00359.1151;ESCO.0722.00359.1151b_05781;3;221;218
ESCO.0722.00359;ESCO.0722.00359.1188;ESCO.0722.00359.1188b_05813;3;218;215
ESCO.0722.00359;ESCO.0722.00359.1225;ESCO.0722.00359.1225b_05845;3;131;128
ESCO.0722.00359;ESCO.0722.00359.1258;ESCO.0722.00359.1258b_05877;1;210;209
ESCO.0722.00359;ESCO.0722.00359.1291;ESCO.0722.00359.1291b_05909;1;147;146
ESCO.0722.00359;ESCO.0722.00359.1326;ESCO.0722.00359.1326b_05941;2;208;206
ESCO.0722.00359;ESCO.0722.00359.0002;ESCO.0722.00359.0002i_00399;23794;24195;401
ESCO.0722.00359;ESCO.0722.00359.0027;ESCO.0722.00359.0027i_03375;45037;45840;803
ESCO.0722.00359;ESCO.0722.00359.0061;ESCO.0722.00359.0061i_04559;5609;5803;194
ESCO.0722.00359;ESCO.0722.00359.0067;ESCO.0722.00359.0067b_04591;3451;3975;524
ESCO.0722.00359;ESCO.0722.00359.0119;ESCO.0722.00359.0119b_04751;1;126;125
ESCO.0722.00359;ESCO.0722.00359.0156;ESCO.0722.00359.0156b_04815;3;773;770
ESCO.0722.00359;ESCO.0722.00359.0178;ESCO.0722.00359.0178b_04847;278;601;323
ESCO.0722.00359;ESCO.0722.00359.0203;ESCO.0722.00359.0203b_04879;242;532;290
ESCO.0722.00359;ESCO.0722.00359.0353;ESCO.0722.00359.0353b_05039;3;365;362
ESCO.0722.00359;ESCO.0722.00359.0409;ESCO.0722.00359.0409b_05103;2;289;287
ESCO.0722.00359;ESCO.0722.00359.0478;ESCO.0722.00359.0478b_05167;1;309;308
ESCO.0722.00359;ESCO.0722.00359.0514;ESCO.0722.00359.0514b_05199;1;165;164
ESCO.0722.00359;ESCO.0722.00359.0549;ESCO.0722.00359.0549b_05231;3;290;287
ESCO.0722.00359;ESCO.0722.00359.0582;ESCO.0722.00359.0582b_05263;3;281;278
ESCO.0722.00359;ESCO.0722.00359.0614;ESCO.0722.00359.0614b_05295;2;271;269
ESCO.0722.00359;ESCO.0722.00359.0649;ESCO.0722.00359.0649b_05327;1;267;266
ESCO.0722.00359;ESCO.0722.00359.0684;ESCO.0722.00359.0684b_05359;1;186;185
ESCO.0722.00359;ESCO.0722.00359.0720;ESCO.0722.00359.0720b_05391;2;214;212
ESCO.0722.00359;ESCO.0722.00359.0751;ESCO.0722.00359.0751b_05423;121;255;134
ESCO.0722.00359;ESCO.0722.00359.0788;ESCO.0722.00359.0788b_05455;119;250;131
ESCO.0722.00359;ESCO.0722.00359.0825;ESCO.0722.00359.0825b_05487;1;114;113
ESCO.0722.00359;ESCO.0722.00359.0859;ESCO.0722.00359.0859b_05519;3;242;239
ESCO.0722.00359;ESCO.0722.00359.0896;ESCO.0722.00359.0896b_05551;2;241;239
ESCO.0722.00359;ESCO.0722.00359.0932;ESCO.0722.00359.0932b_05583;2;238;236
ESCO.0722.00359;ESCO.0722.00359.0965;ESCO.0722.00359.0965b_05615;1;234;233
ESCO.0722.00359;ESCO.0722.00359.0998;ESCO.0722.00359.0998b_05647;2;232;230
ESCO.0722.00359;ESCO.0722.00359.1034;ESCO.0722.00359.1034b_05679;2;229;227
ESCO.0722.00359;ESCO.0722.00359.1073;ESCO.0722.00359.1073b_05711;11;226;215
ESCO.0722.00359;ESCO.0722.00359.1108;ESCO.0722.00359.1108b_05743;41;223;182
ESCO.0722.00359;ESCO.0722.00359.1145;ESCO.0722.00359.1145b_05775;3;221;218
ESCO.0722.00359;ESCO.0722.00359.1181;ESCO.0722.00359.1181b_05807;2;217;215
ESCO.0722.00359;ESCO.0722.00359.1219;ESCO.0722.00359.1219b_05839;1;216;215
ESCO.0722.00359;ESCO.0722.00359.1251;ESCO.0722.00359.1251b_05871;3;212;209
ESCO.0722.00359;ESCO.0722.00359.1284;ESCO.0722.00359.1284b_05903;104;208;104
ESCO.0722.00359;ESCO.0722.00359.1319;ESCO.0722.00359.1319b_05935;1;207;206
ESCO.0722.00359;ESCO.0722.00359.0017;ESCO.0722.00359.0017i_02672;28442;30430;1988
ESCO.0722.00359;ESCO.0722.00359.0027;ESCO.0722.00359.0027i_03376;45866;46432;566
ESCO.0722.00359;ESCO.0722.00359.0068;ESCO.0722.00359.0068b_04592;2;523;521
ESCO.0722.00359;ESCO.0722.00359.0076;ESCO.0722.00359.0076i_04624;4026;4298;272
ESCO.0722.00359;ESCO.0722.00359.0205;ESCO.0722.00359.0205b_04880;1;525;524
ESCO.0722.00359;ESCO.0722.00359.0234;ESCO.0722.00359.0234b_04912;1;471;470
ESCO.0722.00359;ESCO.0722.00359.0322;ESCO.0722.00359.0322b_05008;2;130;128
ESCO.0722.00359;ESCO.0722.00359.0354;ESCO.0722.00359.0354b_05040;2;112;110
ESCO.0722.00359;ESCO.0722.00359.0410;ESCO.0722.00359.0410b_05104;3;248;245
ESCO.0722.00359;ESCO.0722.00359.0446;ESCO.0722.00359.0446b_05136;3;107;104
ESCO.0722.00359;ESCO.0722.00359.0479;ESCO.0722.00359.0479b_05168;1;309;308
ESCO.0722.00359;ESCO.0722.00359.0515;ESCO.0722.00359.0515b_05200;1;297;296
ESCO.0722.00359;ESCO.0722.00359.0550;ESCO.0722.00359.0550b_05232;2;289;287
ESCO.0722.00359;ESCO.0722.00359.0583;ESCO.0722.00359.0583b_05264;2;172;170
ESCO.0722.00359;ESCO.0722.00359.0615;ESCO.0722.00359.0615b_05296;3;272;269
ESCO.0722.00359;ESCO.0722.00359.0650;ESCO.0722.00359.0650b_05328;3;134;131
ESCO.0722.00359;ESCO.0722.00359.0686;ESCO.0722.00359.0686b_05360;2;262;260
ESCO.0722.00359;ESCO.0722.00359.0721;ESCO.0722.00359.0721b_05392;3;260;257
ESCO.0722.00359;ESCO.0722.00359.0752;ESCO.0722.00359.0752b_05424;1;255;254
ESCO.0722.00359;ESCO.0722.00359.0789;ESCO.0722.00359.0789b_05456;3;155;152
ESCO.0722.00359;ESCO.0722.00359.0826;ESCO.0722.00359.0826b_05488;2;247;245
ESCO.0722.00359;ESCO.0722.00359.0897;ESCO.0722.00359.0897b_05552;1;135;134
ESCO.0722.00359;ESCO.0722.00359.0933;ESCO.0722.00359.0933b_05584;1;237;236
ESCO.0722.00359;ESCO.0722.00359.0966;ESCO.0722.00359.0966b_05616;1;234;233
ESCO.0722.00359;ESCO.0722.00359.0999;ESCO.0722.00359.0999b_05648;2;232;230
ESCO.0722.00359;ESCO.0722.00359.1035;ESCO.0722.00359.1035b_05680;2;229;227
ESCO.0722.00359;ESCO.0722.00359.1074;ESCO.0722.00359.1074b_05712;3;224;221
ESCO.0722.00359;ESCO.0722.00359.1110;ESCO.0722.00359.1110b_05744;2;223;221
ESCO.0722.00359;ESCO.0722.00359.1146;ESCO.0722.00359.1146b_05776;1;219;218
ESCO.0722.00359;ESCO.0722.00359.1182;ESCO.0722.00359.1182b_05808;2;217;215
ESCO.0722.00359;ESCO.0722.00359.1220;ESCO.0722.00359.1220b_05840;120;215;95
ESCO.0722.00359;ESCO.0722.00359.1252;ESCO.0722.00359.1252b_05872;1;210;209
ESCO.0722.00359;ESCO.0722.00359.1285;ESCO.0722.00359.1285b_05904;2;94;92
ESCO.0722.00359;ESCO.0722.00359.1321;ESCO.0722.00359.1321b_05936;2;208;206
ESCO.0722.00359;ESCO.0722.00359.1408;ESCO.0722.00359.1408b_06000;3;92;89
ESCO.0722.00359;ESCO.0722.00359.0177;ESCO.0722.00359.0177b_04844;1;114;113
ESCO.0722.00359;ESCO.0722.00359.0201;ESCO.0722.00359.0201b_04876;1;534;533
ESCO.0722.00359;ESCO.0722.00359.0230;ESCO.0722.00359.0230b_04908;43;483;440
ESCO.0722.00359;ESCO.0722.00359.0289;ESCO.0722.00359.0289b_04972;2;193;191
ESCO.0722.00359;ESCO.0722.00359.0318;ESCO.0722.00359.0318b_05004;4;387;383
ESCO.0722.00359;ESCO.0722.00359.0351;ESCO.0722.00359.0351b_05036;2;277;275
ESCO.0722.00359;ESCO.0722.00359.0379;ESCO.0722.00359.0379b_05068;2;229;227
ESCO.0722.00359;ESCO.0722.00359.0406;ESCO.0722.00359.0406b_05100;112;339;227
ESCO.0722.00359;ESCO.0722.00359.0442;ESCO.0722.00359.0442b_05132;1;327;326
ESCO.0722.00359;ESCO.0722.00359.0475;ESCO.0722.00359.0475b_05164;2;310;308
ESCO.0722.00359;ESCO.0722.00359.0510;ESCO.0722.00359.0510b_05196;206;298;92
ESCO.0722.00359;ESCO.0722.00359.0546;ESCO.0722.00359.0546b_05228;1;291;290
ESCO.0722.00359;ESCO.0722.00359.0578;ESCO.0722.00359.0578b_05260;2;154;152
ESCO.0722.00359;ESCO.0722.00359.0610;ESCO.0722.00359.0610b_05292;2;181;179
ESCO.0722.00359;ESCO.0722.00359.0645;ESCO.0722.00359.0645b_05324;1;267;266
ESCO.0722.00359;ESCO.0722.00359.0680;ESCO.0722.00359.0680b_05356;3;263;260
ESCO.0722.00359;ESCO.0722.00359.0717;ESCO.0722.00359.0717b_05388;2;259;257
ESCO.0722.00359;ESCO.0722.00359.0749;ESCO.0722.00359.0749b_05420;3;254;251
ESCO.0722.00359;ESCO.0722.00359.0785;ESCO.0722.00359.0785b_05452;3;251;248
ESCO.0722.00359;ESCO.0722.00359.0822;ESCO.0722.00359.0822b_05484;3;248;245
ESCO.0722.00359;ESCO.0722.00359.0856;ESCO.0722.00359.0856b_05516;3;242;239
ESCO.0722.00359;ESCO.0722.00359.0893;ESCO.0722.00359.0893b_05548;1;240;239
ESCO.0722.00359;ESCO.0722.00359.0928;ESCO.0722.00359.0928b_05580;1;237;236
ESCO.0722.00359;ESCO.0722.00359.0962;ESCO.0722.00359.0962b_05612;1;234;233
ESCO.0722.00359;ESCO.0722.00359.0995;ESCO.0722.00359.0995b_05644;3;233;230
ESCO.0722.00359;ESCO.0722.00359.1031;ESCO.0722.00359.1031b_05676;2;229;227
ESCO.0722.00359;ESCO.0722.00359.1070;ESCO.0722.00359.1070b_05708;2;226;224
ESCO.0722.00359;ESCO.0722.00359.1105;ESCO.0722.00359.1105b_05740;77;223;146
ESCO.0722.00359;ESCO.0722.00359.1142;ESCO.0722.00359.1142b_05772;3;221;218
ESCO.0722.00359;ESCO.0722.00359.1178;ESCO.0722.00359.1178b_05804;2;217;215
ESCO.0722.00359;ESCO.0722.00359.1215;ESCO.0722.00359.1215b_05836;1;216;215
ESCO.0722.00359;ESCO.0722.00359.1249;ESCO.0722.00359.1249b_05868;14;211;197
ESCO.0722.00359;ESCO.0722.00359.1281;ESCO.0722.00359.1281b_05900;1;210;209
ESCO.0722.00359;ESCO.0722.00359.1315;ESCO.0722.00359.1315b_05932;3;206;203
ESCO.0722.00359;ESCO.0722.00359.0135;ESCO.0722.00359.0135b_04781;3;149;146
ESCO.0722.00359;ESCO.0722.00359.0177;ESCO.0722.00359.0177b_04845;121;603;482
ESCO.0722.00359;ESCO.0722.00359.0231;ESCO.0722.00359.0231b_04909;130;474;344
ESCO.0722.00359;ESCO.0722.00359.0351;ESCO.0722.00359.0351b_05037;274;366;92
ESCO.0722.00359;ESCO.0722.00359.0379;ESCO.0722.00359.0379b_05069;246;350;104
ESCO.0722.00359;ESCO.0722.00359.0407;ESCO.0722.00359.0407b_05101;3;119;116
ESCO.0722.00359;ESCO.0722.00359.0443;ESCO.0722.00359.0443b_05133;1;327;326
ESCO.0722.00359;ESCO.0722.00359.0476;ESCO.0722.00359.0476b_05165;96;308;212
ESCO.0722.00359;ESCO.0722.00359.0512;ESCO.0722.00359.0512b_05197;2;94;92
ESCO.0722.00359;ESCO.0722.00359.0547;ESCO.0722.00359.0547b_05229;37;291;254
ESCO.0722.00359;ESCO.0722.00359.0611;ESCO.0722.00359.0611b_05293;3;272;269
ESCO.0722.00359;ESCO.0722.00359.0646;ESCO.0722.00359.0646b_05325;3;269;266
ESCO.0722.00359;ESCO.0722.00359.0681;ESCO.0722.00359.0681b_05357;3;263;260
ESCO.0722.00359;ESCO.0722.00359.0718;ESCO.0722.00359.0718b_05389;2;259;257
ESCO.0722.00359;ESCO.0722.00359.0750;ESCO.0722.00359.0750b_05421;3;254;251
ESCO.0722.00359;ESCO.0722.00359.0786;ESCO.0722.00359.0786b_05453;2;250;248
ESCO.0722.00359;ESCO.0722.00359.0823;ESCO.0722.00359.0823b_05485;3;161;158
ESCO.0722.00359;ESCO.0722.00359.0894;ESCO.0722.00359.0894b_05549;1;240;239
ESCO.0722.00359;ESCO.0722.00359.0929;ESCO.0722.00359.0929b_05581;50;238;188
ESCO.0722.00359;ESCO.0722.00359.0963;ESCO.0722.00359.0963b_05613;3;236;233
ESCO.0722.00359;ESCO.0722.00359.0996;ESCO.0722.00359.0996b_05645;2;232;230
ESCO.0722.00359;ESCO.0722.00359.1032;ESCO.0722.00359.1032b_05677;1;228;227
ESCO.0722.00359;ESCO.0722.00359.1071;ESCO.0722.00359.1071b_05709;2;226;224
ESCO.0722.00359;ESCO.0722.00359.1106;ESCO.0722.00359.1106b_05741;137;223;86
ESCO.0722.00359;ESCO.0722.00359.1143;ESCO.0722.00359.1143b_05773;2;220;218
ESCO.0722.00359;ESCO.0722.00359.1179;ESCO.0722.00359.1179b_05805;3;128;125
ESCO.0722.00359;ESCO.0722.00359.1250;ESCO.0722.00359.1250b_05869;2;88;86
ESCO.0722.00359;ESCO.0722.00359.1282;ESCO.0722.00359.1282b_05901;110;211;101
ESCO.0722.00359;ESCO.0722.00359.1317;ESCO.0722.00359.1317b_05933;2;208;206
ESCO.0722.00359;ESCO.0722.00359.0002;ESCO.0722.00359.0002i_00398;23375;23782;407
ESCO.0722.00359;ESCO.0722.00359.0155;ESCO.0722.00359.0155b_04814;2;787;785
ESCO.0722.00359;ESCO.0722.00359.0178;ESCO.0722.00359.0178b_04846;3;281;278
ESCO.0722.00359;ESCO.0722.00359.0203;ESCO.0722.00359.0203b_04878;1;258;257
ESCO.0722.00359;ESCO.0722.00359.0232;ESCO.0722.00359.0232b_04910;2;475;473
ESCO.0722.00359;ESCO.0722.00359.0352;ESCO.0722.00359.0352b_05038;2;364;362
ESCO.0722.00359;ESCO.0722.00359.0380;ESCO.0722.00359.0380b_05070;2;136;134
ESCO.0722.00359;ESCO.0722.00359.0444;ESCO.0722.00359.0444b_05134;2;325;323
ESCO.0722.00359;ESCO.0722.00359.0513;ESCO.0722.00359.0513b_05198;2;298;296
ESCO.0722.00359;ESCO.0722.00359.0548;ESCO.0722.00359.0548b_05230;1;291;290
ESCO.0722.00359;ESCO.0722.00359.0612;ESCO.0722.00359.0612b_05294;2;271;269
ESCO.0722.00359;ESCO.0722.00359.0647;ESCO.0722.00359.0647b_05326;1;267;266
ESCO.0722.00359;ESCO.0722.00359.0682;ESCO.0722.00359.0682b_05358;1;222;221
ESCO.0722.00359;ESCO.0722.00359.0719;ESCO.0722.00359.0719b_05390;3;260;257
ESCO.0722.00359;ESCO.0722.00359.0751;ESCO.0722.00359.0751b_05422;3;68;65
ESCO.0722.00359;ESCO.0722.00359.0824;ESCO.0722.00359.0824b_05486;77;247;170
ESCO.0722.00359;ESCO.0722.00359.0857;ESCO.0722.00359.0857b_05518;168;242;74
ESCO.0722.00359;ESCO.0722.00359.0895;ESCO.0722.00359.0895b_05550;3;92;89
ESCO.0722.00359;ESCO.0722.00359.0931;ESCO.0722.00359.0931b_05582;3;239;236
ESCO.0722.00359;ESCO.0722.00359.0964;ESCO.0722.00359.0964b_05614;1;213;212
ESCO.0722.00359;ESCO.0722.00359.0997;ESCO.0722.00359.0997b_05646;46;231;185
ESCO.0722.00359;ESCO.0722.00359.1033;ESCO.0722.00359.1033b_05678;1;228;227
ESCO.0722.00359;ESCO.0722.00359.1072;ESCO.0722.00359.1072b_05710;1;225;224
ESCO.0722.00359;ESCO.0722.00359.1107;ESCO.0722.00359.1107b_05742;2;223;221
ESCO.0722.00359;ESCO.0722.00359.1144;ESCO.0722.00359.1144b_05774;3;221;218
ESCO.0722.00359;ESCO.0722.00359.1180;ESCO.0722.00359.1180b_05806;8;217;209
ESCO.0722.00359;ESCO.0722.00359.1217;ESCO.0722.00359.1217b_05838;3;215;212
ESCO.0722.00359;ESCO.0722.00359.1250;ESCO.0722.00359.1250b_05870;85;213;128
ESCO.0722.00359;ESCO.0722.00359.1283;ESCO.0722.00359.1283b_05902;1;210;209
ESCO.0722.00359;ESCO.0722.00359.1318;ESCO.0722.00359.1318b_05934;1;207;206
ESCO.0722.00359;ESCO.0722.00359.1405;ESCO.0722.00359.1405b_05998;2;103;101
ESCO.0722.00359;ESCO.0722.00359.0001;ESCO.0722.00359.0001i_00310;360917;361138;221
ESCO.0722.00359;ESCO.0722.00359.0001;ESCO.0722.00359.0001i_00342;396668;397771;1103
ESCO.0722.00359;ESCO.0722.00359.0020;ESCO.0722.00359.0020i_02870;55419;56390;971
ESCO.0722.00359;ESCO.0722.00359.0043;ESCO.0722.00359.0043i_04342;1501;3048;1547
ESCO.0722.00359;ESCO.0722.00359.0094;ESCO.0722.00359.0094b_04694;1738;2421;683
ESCO.0722.00359;ESCO.0722.00359.0123;ESCO.0722.00359.0123b_04758;301;570;269
ESCO.0722.00359;ESCO.0722.00359.0184;ESCO.0722.00359.0184b_04854;266;475;209
ESCO.0722.00359;ESCO.0722.00359.0210;ESCO.0722.00359.0210b_04886;3;383;380
ESCO.0722.00359;ESCO.0722.00359.0237;ESCO.0722.00359.0237b_04918;268;465;197
ESCO.0722.00359;ESCO.0722.00359.0299;ESCO.0722.00359.0299b_04982;1;402;401
ESCO.0722.00359;ESCO.0722.00359.0329;ESCO.0722.00359.0329b_05014;1;378;377
ESCO.0722.00359;ESCO.0722.00359.0359;ESCO.0722.00359.0359b_05046;3;362;359
ESCO.0722.00359;ESCO.0722.00359.0387;ESCO.0722.00359.0387b_05078;255;347;92
ESCO.0722.00359;ESCO.0722.00359.0419;ESCO.0722.00359.0419b_05110;2;337;335
ESCO.0722.00359;ESCO.0722.00359.0451;ESCO.0722.00359.0451b_05142;2;307;305
ESCO.0722.00359;ESCO.0722.00359.0485;ESCO.0722.00359.0485b_05174;1;306;305
ESCO.0722.00359;ESCO.0722.00359.0523;ESCO.0722.00359.0523b_05206;3;296;293
ESCO.0722.00359;ESCO.0722.00359.0556;ESCO.0722.00359.0556b_05238;2;145;143
ESCO.0722.00359;ESCO.0722.00359.0620;ESCO.0722.00359.0620b_05302;159;272;113
ESCO.0722.00359;ESCO.0722.00359.0656;ESCO.0722.00359.0656b_05334;176;265;89
ESCO.0722.00359;ESCO.0722.00359.0727;ESCO.0722.00359.0727b_05398;3;257;254
ESCO.0722.00359;ESCO.0722.00359.0759;ESCO.0722.00359.0759b_05430;1;255;254
ESCO.0722.00359;ESCO.0722.00359.0795;ESCO.0722.00359.0795b_05462;2;250;248
ESCO.0722.00359;ESCO.0722.00359.0866;ESCO.0722.00359.0866b_05526;3;233;230
ESCO.0722.00359;ESCO.0722.00359.0903;ESCO.0722.00359.0903b_05558;1;240;239
ESCO.0722.00359;ESCO.0722.00359.0939;ESCO.0722.00359.0939b_05590;3;236;233
ESCO.0722.00359;ESCO.0722.00359.0972;ESCO.0722.00359.0972b_05622;2;235;233
ESCO.0722.00359;ESCO.0722.00359.1005;ESCO.0722.00359.1005b_05654;3;230;227
ESCO.0722.00359;ESCO.0722.00359.1041;ESCO.0722.00359.1041b_05686;3;122;119
ESCO.0722.00359;ESCO.0722.00359.1081;ESCO.0722.00359.1081b_05718;3;224;221
ESCO.0722.00359;ESCO.0722.00359.1117;ESCO.0722.00359.1117b_05750;2;187;185
ESCO.0722.00359;ESCO.0722.00359.1153;ESCO.0722.00359.1153b_05782;37;219;182
ESCO.0722.00359;ESCO.0722.00359.1189;ESCO.0722.00359.1189b_05814;1;216;215
ESCO.0722.00359;ESCO.0722.00359.1225;ESCO.0722.00359.1225b_05846;94;213;119
ESCO.0722.00359;ESCO.0722.00359.1259;ESCO.0722.00359.1259b_05878;2;211;209
ESCO.0722.00359;ESCO.0722.00359.1292;ESCO.0722.00359.1292b_05910;2;208;206
ESCO.0722.00359;ESCO.0722.00359.1327;ESCO.0722.00359.1327b_05942;3;206;203
ESCO.0722.00359;ESCO.0722.00359.0034;ESCO.0722.00359.0034i_04128;32007;32222;215
ESCO.0722.00359;ESCO.0722.00359.0043;ESCO.0722.00359.0043i_04352;13405;14304;899
ESCO.0722.00359;ESCO.0722.00359.0191;ESCO.0722.00359.0191b_04864;1;561;560
ESCO.0722.00359;ESCO.0722.00359.0220;ESCO.0722.00359.0220b_04896;3;509;506
ESCO.0722.00359;ESCO.0722.00359.0249;ESCO.0722.00359.0249b_04928;3;302;299
ESCO.0722.00359;ESCO.0722.00359.0276;ESCO.0722.00359.0276b_04960;2;178;176
ESCO.0722.00359;ESCO.0722.00359.0306;ESCO.0722.00359.0306b_04992;2;397;395
ESCO.0722.00359;ESCO.0722.00359.0339;ESCO.0722.00359.0339b_05024;1;375;374
ESCO.0722.00359;ESCO.0722.00359.0368;ESCO.0722.00359.0368b_05056;3;359;356
ESCO.0722.00359;ESCO.0722.00359.0429;ESCO.0722.00359.0429b_05120;1;333;332
ESCO.0722.00359;ESCO.0722.00359.0462;ESCO.0722.00359.0462b_05152;1;300;299
ESCO.0722.00359;ESCO.0722.00359.0497;ESCO.0722.00359.0497b_05184;2;304;302
ESCO.0722.00359;ESCO.0722.00359.0533;ESCO.0722.00359.0533b_05216;2;295;293
ESCO.0722.00359;ESCO.0722.00359.0566;ESCO.0722.00359.0566b_05248;3;173;170
ESCO.0722.00359;ESCO.0722.00359.0598;ESCO.0722.00359.0598b_05280;17;274;257
ESCO.0722.00359;ESCO.0722.00359.0633;ESCO.0722.00359.0633b_05312;1;270;269
ESCO.0722.00359;ESCO.0722.00359.0668;ESCO.0722.00359.0668b_05344;2;265;263
ESCO.0722.00359;ESCO.0722.00359.0704;ESCO.0722.00359.0704b_05376;1;261;260
ESCO.0722.00359;ESCO.0722.00359.0736;ESCO.0722.00359.0736b_05408;2;256;254
ESCO.0722.00359;ESCO.0722.00359.0771;ESCO.0722.00359.0771b_05440;3;254;251
ESCO.0722.00359;ESCO.0722.00359.0809;ESCO.0722.00359.0809b_05472;2;250;248
ESCO.0722.00359;ESCO.0722.00359.0844;ESCO.0722.00359.0844b_05504;3;245;242
ESCO.0722.00359;ESCO.0722.00359.0876;ESCO.0722.00359.0876b_05536;1;243;242
ESCO.0722.00359;ESCO.0722.00359.0912;ESCO.0722.00359.0912b_05568;1;240;239
ESCO.0722.00359;ESCO.0722.00359.0950;ESCO.0722.00359.0950b_05600;3;236;233
ESCO.0722.00359;ESCO.0722.00359.1018;ESCO.0722.00359.1018b_05664;2;229;227
ESCO.0722.00359;ESCO.0722.00359.1057;ESCO.0722.00359.1057b_05696;95;226;131
ESCO.0722.00359;ESCO.0722.00359.1092;ESCO.0722.00359.1092b_05728;1;225;224
ESCO.0722.00359;ESCO.0722.00359.1127;ESCO.0722.00359.1127b_05760;1;222;221
ESCO.0722.00359;ESCO.0722.00359.1163;ESCO.0722.00359.1163b_05792;1;219;218
ESCO.0722.00359;ESCO.0722.00359.1203;ESCO.0722.00359.1203b_05824;3;215;212
ESCO.0722.00359;ESCO.0722.00359.1237;ESCO.0722.00359.1237b_05856;3;131;128
ESCO.0722.00359;ESCO.0722.00359.1268;ESCO.0722.00359.1268b_05888;1;210;209
ESCO.0722.00359;ESCO.0722.00359.1303;ESCO.0722.00359.1303b_05920;3;137;134
ESCO.0722.00359;ESCO.0722.00359.1340;ESCO.0722.00359.1340b_05952;2;205;203
ESCO.0722.00359;ESCO.0722.00359.0019;ESCO.0722.00359.0019i_02785;50588;50695;107
ESCO.0722.00359;ESCO.0722.00359.0043;ESCO.0722.00359.0043i_04353;14334;15851;1517
ESCO.0722.00359;ESCO.0722.00359.0113;ESCO.0722.00359.0113b_04737;224;664;440
ESCO.0722.00359;ESCO.0722.00359.0192;ESCO.0722.00359.0192b_04865;1;558;557
ESCO.0722.00359;ESCO.0722.00359.0250;ESCO.0722.00359.0250b_04929;2;247;245
ESCO.0722.00359;ESCO.0722.00359.0276;ESCO.0722.00359.0276b_04961;325;420;95
ESCO.0722.00359;ESCO.0722.00359.0340;ESCO.0722.00359.0340b_05025;3;374;371
ESCO.0722.00359;ESCO.0722.00359.0369;ESCO.0722.00359.0369b_05057;1;108;107
ESCO.0722.00359;ESCO.0722.00359.0396;ESCO.0722.00359.0396b_05089;115;345;230
ESCO.0722.00359;ESCO.0722.00359.0430;ESCO.0722.00359.0430b_05121;2;334;332
ESCO.0722.00359;ESCO.0722.00359.0463;ESCO.0722.00359.0463b_05153;51;317;266
ESCO.0722.00359;ESCO.0722.00359.0498;ESCO.0722.00359.0498b_05185;3;212;209
ESCO.0722.00359;ESCO.0722.00359.0534;ESCO.0722.00359.0534b_05217;3;293;290
ESCO.0722.00359;ESCO.0722.00359.0567;ESCO.0722.00359.0567b_05249;2;265;263
ESCO.0722.00359;ESCO.0722.00359.0599;ESCO.0722.00359.0599b_05281;1;276;275
ESCO.0722.00359;ESCO.0722.00359.0634;ESCO.0722.00359.0634b_05313;42;269;227
ESCO.0722.00359;ESCO.0722.00359.0669;ESCO.0722.00359.0669b_05345;1;264;263
ESCO.0722.00359;ESCO.0722.00359.0737;ESCO.0722.00359.0737b_05409;2;184;182
ESCO.0722.00359;ESCO.0722.00359.0772;ESCO.0722.00359.0772b_05441;2;253;251
ESCO.0722.00359;ESCO.0722.00359.0810;ESCO.0722.00359.0810b_05473;3;248;245
ESCO.0722.00359;ESCO.0722.00359.0845;ESCO.0722.00359.0845b_05505;3;245;242
ESCO.0722.00359;ESCO.0722.00359.0878;ESCO.0722.00359.0878b_05537;3;242;239
ESCO.0722.00359;ESCO.0722.00359.0914;ESCO.0722.00359.0914b_05569;3;239;236
ESCO.0722.00359;ESCO.0722.00359.0951;ESCO.0722.00359.0951b_05601;92;238;146
ESCO.0722.00359;ESCO.0722.00359.1020;ESCO.0722.00359.1020b_05665;3;230;227
ESCO.0722.00359;ESCO.0722.00359.1058;ESCO.0722.00359.1058b_05697;3;227;224
ESCO.0722.00359;ESCO.0722.00359.1093;ESCO.0722.00359.1093b_05729;1;225;224
ESCO.0722.00359;ESCO.0722.00359.1128;ESCO.0722.00359.1128b_05761;3;221;218
ESCO.0722.00359;ESCO.0722.00359.1164;ESCO.0722.00359.1164b_05793;61;219;158
ESCO.0722.00359;ESCO.0722.00359.1204;ESCO.0722.00359.1204b_05825;3;215;212
ESCO.0722.00359;ESCO.0722.00359.1238;ESCO.0722.00359.1238b_05857;1;126;125
ESCO.0722.00359;ESCO.0722.00359.1269;ESCO.0722.00359.1269b_05889;2;211;209
ESCO.0722.00359;ESCO.0722.00359.1304;ESCO.0722.00359.1304b_05921;9;209;200
ESCO.0722.00359;ESCO.0722.00359.1341;ESCO.0722.00359.1341b_05953;2;205;203
ESCO.0722.00359;ESCO.0722.00359.0016;ESCO.0722.00359.0016i_02594;130282;130446;164
ESCO.0722.00359;ESCO.0722.00359.0017;ESCO.0722.00359.0017i_02690;39255;39473;218
ESCO.0722.00359;ESCO.0722.00359.0065;ESCO.0722.00359.0065i_04578;3987;5720;1733
ESCO.0722.00359;ESCO.0722.00359.0170;ESCO.0722.00359.0170b_04834;3;134;131
ESCO.0722.00359;ESCO.0722.00359.0193;ESCO.0722.00359.0193b_04866;3;410;407
ESCO.0722.00359;ESCO.0722.00359.0221;ESCO.0722.00359.0221b_04898;252;509;257
ESCO.0722.00359;ESCO.0722.00359.0251;ESCO.0722.00359.0251b_04930;2;238;236
ESCO.0722.00359;ESCO.0722.00359.0277;ESCO.0722.00359.0277b_04962;2;418;416
ESCO.0722.00359;ESCO.0722.00359.0307;ESCO.0722.00359.0307b_04994;309;395;86
ESCO.0722.00359;ESCO.0722.00359.0397;ESCO.0722.00359.0397b_05090;1;177;176
ESCO.0722.00359;ESCO.0722.00359.0431;ESCO.0722.00359.0431b_05122;1;312;311
ESCO.0722.00359;ESCO.0722.00359.0464;ESCO.0722.00359.0464b_05154;1;315;314
ESCO.0722.00359;ESCO.0722.00359.0499;ESCO.0722.00359.0499b_05186;1;243;242
ESCO.0722.00359;ESCO.0722.00359.0535;ESCO.0722.00359.0535b_05218;2;292;290
ESCO.0722.00359;ESCO.0722.00359.0568;ESCO.0722.00359.0568b_05250;3;140;137
ESCO.0722.00359;ESCO.0722.00359.0600;ESCO.0722.00359.0600b_05282;5;274;269
ESCO.0722.00359;ESCO.0722.00359.0635;ESCO.0722.00359.0635b_05314;3;269;266
ESCO.0722.00359;ESCO.0722.00359.0670;ESCO.0722.00359.0670b_05346;1;123;122
ESCO.0722.00359;ESCO.0722.00359.0706;ESCO.0722.00359.0706b_05378;1;261;260
ESCO.0722.00359;ESCO.0722.00359.0773;ESCO.0722.00359.0773b_05442;1;252;251
ESCO.0722.00359;ESCO.0722.00359.0811;ESCO.0722.00359.0811b_05474;3;248;245
ESCO.0722.00359;ESCO.0722.00359.0846;ESCO.0722.00359.0846b_05506;2;64;62
ESCO.0722.00359;ESCO.0722.00359.0881;ESCO.0722.00359.0881b_05538;3;242;239
ESCO.0722.00359;ESCO.0722.00359.0915;ESCO.0722.00359.0915b_05570;3;98;95
ESCO.0722.00359;ESCO.0722.00359.0952;ESCO.0722.00359.0952b_05602;53;235;182
ESCO.0722.00359;ESCO.0722.00359.0985;ESCO.0722.00359.0985b_05634;3;101;98
ESCO.0722.00359;ESCO.0722.00359.1021;ESCO.0722.00359.1021b_05666;1;231;230
ESCO.0722.00359;ESCO.0722.00359.1059;ESCO.0722.00359.1059b_05698;153;227;74
ESCO.0722.00359;ESCO.0722.00359.1094;ESCO.0722.00359.1094b_05730;2;223;221
ESCO.0722.00359;ESCO.0722.00359.1129;ESCO.0722.00359.1129b_05762;66;221;155
ESCO.0722.00359;ESCO.0722.00359.1165;ESCO.0722.00359.1165b_05794;3;218;215
ESCO.0722.00359;ESCO.0722.00359.1205;ESCO.0722.00359.1205b_05826;1;216;215
ESCO.0722.00359;ESCO.0722.00359.1238;ESCO.0722.00359.1238b_05858;119;214;95
ESCO.0722.00359;ESCO.0722.00359.1270;ESCO.0722.00359.1270b_05890;2;211;209
ESCO.0722.00359;ESCO.0722.00359.1305;ESCO.0722.00359.1305b_05922;135;209;74
ESCO.0722.00359;ESCO.0722.00359.1342;ESCO.0722.00359.1342b_05954;3;206;203
ESCO.0722.00359;ESCO.0722.00359.0043;ESCO.0722.00359.0043i_04350;11806;12294;488
ESCO.0722.00359;ESCO.0722.00359.0048;ESCO.0722.00359.0048b_04446;10527;11465;938
ESCO.0722.00359;ESCO.0722.00359.0087;ESCO.0722.00359.0087i_04670;921;1169;248
ESCO.0722.00359;ESCO.0722.00359.0097;ESCO.0722.00359.0097b_04702;3;1523;1520
ESCO.0722.00359;ESCO.0722.00359.0127;ESCO.0722.00359.0127b_04766;3;1154;1151
ESCO.0722.00359;ESCO.0722.00359.0168;ESCO.0722.00359.0168b_04830;3;428;425
ESCO.0722.00359;ESCO.0722.00359.0190;ESCO.0722.00359.0190b_04862;3;455;452
ESCO.0722.00359;ESCO.0722.00359.0218;ESCO.0722.00359.0218b_04894;2;511;509
ESCO.0722.00359;ESCO.0722.00359.0246;ESCO.0722.00359.0246b_04926;2;454;452
ESCO.0722.00359;ESCO.0722.00359.0275;ESCO.0722.00359.0275b_04958;2;97;95
ESCO.0722.00359;ESCO.0722.00359.0304;ESCO.0722.00359.0304b_04990;1;399;398
ESCO.0722.00359;ESCO.0722.00359.0336;ESCO.0722.00359.0336b_05022;171;377;206
ESCO.0722.00359;ESCO.0722.00359.0366;ESCO.0722.00359.0366b_05054;3;359;356
ESCO.0722.00359;ESCO.0722.00359.0393;ESCO.0722.00359.0393b_05086;211;345;134
ESCO.0722.00359;ESCO.0722.00359.0427;ESCO.0722.00359.0427b_05118;2;334;332
ESCO.0722.00359;ESCO.0722.00359.0460;ESCO.0722.00359.0460b_05150;3;320;317
ESCO.0722.00359;ESCO.0722.00359.0496;ESCO.0722.00359.0496b_05182;1;222;221
ESCO.0722.00359;ESCO.0722.00359.0532;ESCO.0722.00359.0532b_05214;3;131;128
ESCO.0722.00359;ESCO.0722.00359.0596;ESCO.0722.00359.0596b_05278;3;275;272
ESCO.0722.00359;ESCO.0722.00359.0629;ESCO.0722.00359.0629b_05310;1;270;269
ESCO.0722.00359;ESCO.0722.00359.0666;ESCO.0722.00359.0666b_05342;2;265;263
ESCO.0722.00359;ESCO.0722.00359.0699;ESCO.0722.00359.0699b_05374;110;262;152
ESCO.0722.00359;ESCO.0722.00359.0734;ESCO.0722.00359.0734b_05406;3;257;254
ESCO.0722.00359;ESCO.0722.00359.0769;ESCO.0722.00359.0769b_05438;1;252;251
ESCO.0722.00359;ESCO.0722.00359.0806;ESCO.0722.00359.0806b_05470;2;250;248
ESCO.0722.00359;ESCO.0722.00359.0842;ESCO.0722.00359.0842b_05502;1;246;245
ESCO.0722.00359;ESCO.0722.00359.0874;ESCO.0722.00359.0874b_05534;3;221;218
ESCO.0722.00359;ESCO.0722.00359.0910;ESCO.0722.00359.0910b_05566;3;131;128
ESCO.0722.00359;ESCO.0722.00359.0948;ESCO.0722.00359.0948b_05598;1;237;236
ESCO.0722.00359;ESCO.0722.00359.0980;ESCO.0722.00359.0980b_05630;1;234;233
ESCO.0722.00359;ESCO.0722.00359.1016;ESCO.0722.00359.1016b_05662;3;230;227
ESCO.0722.00359;ESCO.0722.00359.1055;ESCO.0722.00359.1055b_05694;54;227;173
ESCO.0722.00359;ESCO.0722.00359.1090;ESCO.0722.00359.1090b_05726;2;202;200
ESCO.0722.00359;ESCO.0722.00359.1125;ESCO.0722.00359.1125b_05758;2;223;221
ESCO.0722.00359;ESCO.0722.00359.1160;ESCO.0722.00359.1160b_05790;1;219;218
ESCO.0722.00359;ESCO.0722.00359.1200;ESCO.0722.00359.1200b_05822;3;203;200
ESCO.0722.00359;ESCO.0722.00359.1235;ESCO.0722.00359.1235b_05854;2;214;212
ESCO.0722.00359;ESCO.0722.00359.1266;ESCO.0722.00359.1266b_05886;2;211;209
ESCO.0722.00359;ESCO.0722.00359.1301;ESCO.0722.00359.1301b_05918;1;207;206
ESCO.0722.00359;ESCO.0722.00359.1338;ESCO.0722.00359.1338b_05950;2;205;203
ESCO.0722.00359;ESCO.0722.00359.1380;ESCO.0722.00359.1380b_05982;3;134;131
ESCO.0722.00359;ESCO.0722.00359.0034;ESCO.0722.00359.0034i_04127;31631;32014;383
ESCO.0722.00359;ESCO.0722.00359.0043;ESCO.0722.00359.0043i_04351;12291;13235;944
ESCO.0722.00359;ESCO.0722.00359.0168;ESCO.0722.00359.0168b_04831;425;646;221
ESCO.0722.00359;ESCO.0722.00359.0190;ESCO.0722.00359.0190b_04863;452;562;110
ESCO.0722.00359;ESCO.0722.00359.0219;ESCO.0722.00359.0219b_04895;2;385;383
ESCO.0722.00359;ESCO.0722.00359.0248;ESCO.0722.00359.0248b_04927;70;264;194
ESCO.0722.00359;ESCO.0722.00359.0275;ESCO.0722.00359.0275b_04959;147;419;272
ESCO.0722.00359;ESCO.0722.00359.0305;ESCO.0722.00359.0305b_04991;87;398;311
ESCO.0722.00359;ESCO.0722.00359.0337;ESCO.0722.00359.0337b_05023;2;376;374
ESCO.0722.00359;ESCO.0722.00359.0394;ESCO.0722.00359.0394b_05087;1;345;344
ESCO.0722.00359;ESCO.0722.00359.0428;ESCO.0722.00359.0428b_05119;3;293;290
ESCO.0722.00359;ESCO.0722.00359.0461;ESCO.0722.00359.0461b_05151;1;318;317
ESCO.0722.00359;ESCO.0722.00359.0496;ESCO.0722.00359.0496b_05183;222;305;83
ESCO.0722.00359;ESCO.0722.00359.0532;ESCO.0722.00359.0532b_05215;128;295;167
ESCO.0722.00359;ESCO.0722.00359.0565;ESCO.0722.00359.0565b_05247;30;287;257
ESCO.0722.00359;ESCO.0722.00359.0597;ESCO.0722.00359.0597b_05279;3;275;272
ESCO.0722.00359;ESCO.0722.00359.0630;ESCO.0722.00359.0630b_05311;2;271;269
ESCO.0722.00359;ESCO.0722.00359.0667;ESCO.0722.00359.0667b_05343;3;134;131
ESCO.0722.00359;ESCO.0722.00359.0700;ESCO.0722.00359.0700b_05375;3;260;257
ESCO.0722.00359;ESCO.0722.00359.0735;ESCO.0722.00359.0735b_05407;1;198;197
ESCO.0722.00359;ESCO.0722.00359.0770;ESCO.0722.00359.0770b_05439;2;253;251
ESCO.0722.00359;ESCO.0722.00359.0808;ESCO.0722.00359.0808b_05471;167;250;83
ESCO.0722.00359;ESCO.0722.00359.0843;ESCO.0722.00359.0843b_05503;3;245;242
ESCO.0722.00359;ESCO.0722.00359.0875;ESCO.0722.00359.0875b_05535;3;77;74
ESCO.0722.00359;ESCO.0722.00359.0910;ESCO.0722.00359.0910b_05567;143;238;95
ESCO.0722.00359;ESCO.0722.00359.0949;ESCO.0722.00359.0949b_05599;2;238;236
ESCO.0722.00359;ESCO.0722.00359.1017;ESCO.0722.00359.1017b_05663;3;230;227
ESCO.0722.00359;ESCO.0722.00359.1056;ESCO.0722.00359.1056b_05695;2;226;224
ESCO.0722.00359;ESCO.0722.00359.1091;ESCO.0722.00359.1091b_05727;2;223;221
ESCO.0722.00359;ESCO.0722.00359.1126;ESCO.0722.00359.1126b_05759;3;221;218
ESCO.0722.00359;ESCO.0722.00359.1202;ESCO.0722.00359.1202b_05823;3;215;212
ESCO.0722.00359;ESCO.0722.00359.1236;ESCO.0722.00359.1236b_05855;3;104;101
ESCO.0722.00359;ESCO.0722.00359.1267;ESCO.0722.00359.1267b_05887;2;211;209
ESCO.0722.00359;ESCO.0722.00359.1302;ESCO.0722.00359.1302b_05919;3;209;206
ESCO.0722.00359;ESCO.0722.00359.1339;ESCO.0722.00359.1339b_05951;3;206;203
ESCO.0722.00359;ESCO.0722.00359.0017;ESCO.0722.00359.0017i_02688;37928;38107;179
ESCO.0722.00359;ESCO.0722.00359.0075;ESCO.0722.00359.0075i_04617;1998;3164;1166
ESCO.0722.00359;ESCO.0722.00359.0090;ESCO.0722.00359.0090b_04681;2;1516;1514
ESCO.0722.00359;ESCO.0722.00359.0132;ESCO.0722.00359.0132b_04777;409;1038;629
ESCO.0722.00359;ESCO.0722.00359.0174;ESCO.0722.00359.0174b_04841;172;609;437
ESCO.0722.00359;ESCO.0722.00359.0199;ESCO.0722.00359.0199b_04873;390;542;152
ESCO.0722.00359;ESCO.0722.00359.0227;ESCO.0722.00359.0227b_04905;404;490;86
ESCO.0722.00359;ESCO.0722.00359.0284;ESCO.0722.00359.0284b_04969;1;414;413
ESCO.0722.00359;ESCO.0722.00359.0315;ESCO.0722.00359.0315b_05001;3;389;386
ESCO.0722.00359;ESCO.0722.00359.0376;ESCO.0722.00359.0376b_05065;3;353;350
ESCO.0722.00359;ESCO.0722.00359.0402;ESCO.0722.00359.0402b_05097;174;341;167
ESCO.0722.00359;ESCO.0722.00359.0438;ESCO.0722.00359.0438b_05129;3;329;326
ESCO.0722.00359;ESCO.0722.00359.0470;ESCO.0722.00359.0470b_05161;2;313;311
ESCO.0722.00359;ESCO.0722.00359.0506;ESCO.0722.00359.0506b_05193;1;300;299
ESCO.0722.00359;ESCO.0722.00359.0542;ESCO.0722.00359.0542b_05225;120;293;173
ESCO.0722.00359;ESCO.0722.00359.0643;ESCO.0722.00359.0643b_05321;2;133;131
ESCO.0722.00359;ESCO.0722.00359.0677;ESCO.0722.00359.0677b_05353;2;211;209
ESCO.0722.00359;ESCO.0722.00359.0713;ESCO.0722.00359.0713b_05385;3;260;257
ESCO.0722.00359;ESCO.0722.00359.0746;ESCO.0722.00359.0746b_05417;2;256;254
ESCO.0722.00359;ESCO.0722.00359.0781;ESCO.0722.00359.0781b_05449;3;110;107
ESCO.0722.00359;ESCO.0722.00359.0819;ESCO.0722.00359.0819b_05481;1;249;248
ESCO.0722.00359;ESCO.0722.00359.0853;ESCO.0722.00359.0853b_05513;1;243;242
ESCO.0722.00359;ESCO.0722.00359.0890;ESCO.0722.00359.0890b_05545;1;240;239
ESCO.0722.00359;ESCO.0722.00359.0923;ESCO.0722.00359.0923b_05577;3;239;236
ESCO.0722.00359;ESCO.0722.00359.0959;ESCO.0722.00359.0959b_05609;137;235;98
ESCO.0722.00359;ESCO.0722.00359.0992;ESCO.0722.00359.0992b_05641;3;233;230
ESCO.0722.00359;ESCO.0722.00359.1028;ESCO.0722.00359.1028b_05673;3;230;227
ESCO.0722.00359;ESCO.0722.00359.1067;ESCO.0722.00359.1067b_05705;94;225;131
ESCO.0722.00359;ESCO.0722.00359.1102;ESCO.0722.00359.1102b_05737;38;223;185
ESCO.0722.00359;ESCO.0722.00359.1137;ESCO.0722.00359.1137b_05769;3;221;218
ESCO.0722.00359;ESCO.0722.00359.1175;ESCO.0722.00359.1175b_05801;3;218;215
ESCO.0722.00359;ESCO.0722.00359.1212;ESCO.0722.00359.1212b_05833;2;214;212
ESCO.0722.00359;ESCO.0722.00359.1245;ESCO.0722.00359.1245b_05865;1;213;212
ESCO.0722.00359;ESCO.0722.00359.1278;ESCO.0722.00359.1278b_05897;3;209;206
ESCO.0722.00359;ESCO.0722.00359.1313;ESCO.0722.00359.1313b_05929;2;208;206
ESCO.0722.00359;ESCO.0722.00359.1351;ESCO.0722.00359.1351b_05961;3;98;95
ESCO.0722.00359;ESCO.0722.00359.0061;ESCO.0722.00359.0061b_04554;55;1188;1133
ESCO.0722.00359;ESCO.0722.00359.0151;ESCO.0722.00359.0151b_04810;2;184;182
ESCO.0722.00359;ESCO.0722.00359.0175;ESCO.0722.00359.0175b_04842;1;606;605
ESCO.0722.00359;ESCO.0722.00359.0200;ESCO.0722.00359.0200b_04874;1;192;191
ESCO.0722.00359;ESCO.0722.00359.0228;ESCO.0722.00359.0228b_04906;2;433;431
ESCO.0722.00359;ESCO.0722.00359.0259;ESCO.0722.00359.0259b_04938;2;439;437
ESCO.0722.00359;ESCO.0722.00359.0285;ESCO.0722.00359.0285b_04970;236;415;179
ESCO.0722.00359;ESCO.0722.00359.0316;ESCO.0722.00359.0316b_05002;1;390;389
ESCO.0722.00359;ESCO.0722.00359.0349;ESCO.0722.00359.0349b_05034;3;365;362
ESCO.0722.00359;ESCO.0722.00359.0404;ESCO.0722.00359.0404b_05098;58;339;281
ESCO.0722.00359;ESCO.0722.00359.0439;ESCO.0722.00359.0439b_05130;2;328;326
ESCO.0722.00359;ESCO.0722.00359.0471;ESCO.0722.00359.0471b_05162;3;311;308
ESCO.0722.00359;ESCO.0722.00359.0509;ESCO.0722.00359.0509b_05194;2;298;296
ESCO.0722.00359;ESCO.0722.00359.0543;ESCO.0722.00359.0543b_05226;3;173;170
ESCO.0722.00359;ESCO.0722.00359.0576;ESCO.0722.00359.0576b_05258;3;284;281
ESCO.0722.00359;ESCO.0722.00359.0608;ESCO.0722.00359.0608b_05290;2;271;269
ESCO.0722.00359;ESCO.0722.00359.0643;ESCO.0722.00359.0643b_05322;180;269;89
ESCO.0722.00359;ESCO.0722.00359.0678;ESCO.0722.00359.0678b_05354;3;263;260
ESCO.0722.00359;ESCO.0722.00359.0714;ESCO.0722.00359.0714b_05386;1;147;146
ESCO.0722.00359;ESCO.0722.00359.0747;ESCO.0722.00359.0747b_05418;1;255;254
ESCO.0722.00359;ESCO.0722.00359.0782;ESCO.0722.00359.0782b_05450;1;252;251
ESCO.0722.00359;ESCO.0722.00359.0820;ESCO.0722.00359.0820b_05482;1;249;248
ESCO.0722.00359;ESCO.0722.00359.0854;ESCO.0722.00359.0854b_05514;12;245;233
ESCO.0722.00359;ESCO.0722.00359.0891;ESCO.0722.00359.0891b_05546;1;240;239
ESCO.0722.00359;ESCO.0722.00359.0925;ESCO.0722.00359.0925b_05578;3;239;236
ESCO.0722.00359;ESCO.0722.00359.0960;ESCO.0722.00359.0960b_05610;3;236;233
ESCO.0722.00359;ESCO.0722.00359.0993;ESCO.0722.00359.0993b_05642;2;232;230
ESCO.0722.00359;ESCO.0722.00359.1029;ESCO.0722.00359.1029b_05674;2;229;227
ESCO.0722.00359;ESCO.0722.00359.1068;ESCO.0722.00359.1068b_05706;1;225;224
ESCO.0722.00359;ESCO.0722.00359.1103;ESCO.0722.00359.1103b_05738;7;222;215
ESCO.0722.00359;ESCO.0722.00359.1138;ESCO.0722.00359.1138b_05770;3;221;218
ESCO.0722.00359;ESCO.0722.00359.1176;ESCO.0722.00359.1176b_05802;6;218;212
ESCO.0722.00359;ESCO.0722.00359.1213;ESCO.0722.00359.1213b_05834;73;216;143
ESCO.0722.00359;ESCO.0722.00359.1246;ESCO.0722.00359.1246b_05866;3;212;209
ESCO.0722.00359;ESCO.0722.00359.1279;ESCO.0722.00359.1279b_05898;3;158;155
ESCO.0722.00359;ESCO.0722.00359.1314;ESCO.0722.00359.1314b_05930;1;129;128
ESCO.0722.00359;ESCO.0722.00359.0061;ESCO.0722.00359.0061i_04555;2243;2749;506
ESCO.0722.00359;ESCO.0722.00359.0075;ESCO.0722.00359.0075b_04619;3902;4576;674
ESCO.0722.00359;ESCO.0722.00359.0101;ESCO.0722.00359.0101b_04715;1738;2007;269
ESCO.0722.00359;ESCO.0722.00359.0117;ESCO.0722.00359.0117b_04747;1082;1402;320
ESCO.0722.00359;ESCO.0722.00359.0134;ESCO.0722.00359.0134b_04779;2;346;344
ESCO.0722.00359;ESCO.0722.00359.0151;ESCO.0722.00359.0151b_04811;681;818;137
ESCO.0722.00359;ESCO.0722.00359.0176;ESCO.0722.00359.0176b_04843;305;604;299
ESCO.0722.00359;ESCO.0722.00359.0200;ESCO.0722.00359.0200b_04875;312;452;140
ESCO.0722.00359;ESCO.0722.00359.0229;ESCO.0722.00359.0229b_04907;1;486;485
ESCO.0722.00359;ESCO.0722.00359.0287;ESCO.0722.00359.0287b_04971;1;414;413
ESCO.0722.00359;ESCO.0722.00359.0317;ESCO.0722.00359.0317b_05003;1;390;389
ESCO.0722.00359;ESCO.0722.00359.0350;ESCO.0722.00359.0350b_05035;3;365;362
ESCO.0722.00359;ESCO.0722.00359.0441;ESCO.0722.00359.0441b_05131;2;328;326
ESCO.0722.00359;ESCO.0722.00359.0473;ESCO.0722.00359.0473b_05163;3;311;308
ESCO.0722.00359;ESCO.0722.00359.0510;ESCO.0722.00359.0510b_05195;2;196;194
ESCO.0722.00359;ESCO.0722.00359.0545;ESCO.0722.00359.0545b_05227;3;290;287
ESCO.0722.00359;ESCO.0722.00359.0577;ESCO.0722.00359.0577b_05259;180;284;104
ESCO.0722.00359;ESCO.0722.00359.0609;ESCO.0722.00359.0609b_05291;2;271;269
ESCO.0722.00359;ESCO.0722.00359.0644;ESCO.0722.00359.0644b_05323;1;270;269
ESCO.0722.00359;ESCO.0722.00359.0679;ESCO.0722.00359.0679b_05355;1;264;263
ESCO.0722.00359;ESCO.0722.00359.0748;ESCO.0722.00359.0748b_05419;3;119;116
ESCO.0722.00359;ESCO.0722.00359.0783;ESCO.0722.00359.0783b_05451;2;250;248
ESCO.0722.00359;ESCO.0722.00359.0821;ESCO.0722.00359.0821b_05483;1;249;248
ESCO.0722.00359;ESCO.0722.00359.0855;ESCO.0722.00359.0855b_05515;2;244;242
ESCO.0722.00359;ESCO.0722.00359.0892;ESCO.0722.00359.0892b_05547;3;239;236
ESCO.0722.00359;ESCO.0722.00359.0927;ESCO.0722.00359.0927b_05579;124;237;113
ESCO.0722.00359;ESCO.0722.00359.0961;ESCO.0722.00359.0961b_05611;1;234;233
ESCO.0722.00359;ESCO.0722.00359.0994;ESCO.0722.00359.0994b_05643;1;231;230
ESCO.0722.00359;ESCO.0722.00359.1030;ESCO.0722.00359.1030b_05675;3;230;227
ESCO.0722.00359;ESCO.0722.00359.1069;ESCO.0722.00359.1069b_05707;1;225;224
ESCO.0722.00359;ESCO.0722.00359.1104;ESCO.0722.00359.1104b_05739;1;150;149
ESCO.0722.00359;ESCO.0722.00359.1139;ESCO.0722.00359.1139b_05771;1;222;221
ESCO.0722.00359;ESCO.0722.00359.1177;ESCO.0722.00359.1177b_05803;1;180;179
ESCO.0722.00359;ESCO.0722.00359.1214;ESCO.0722.00359.1214b_05835;20;214;194
ESCO.0722.00359;ESCO.0722.00359.1280;ESCO.0722.00359.1280b_05899;1;210;209
ESCO.0722.00359;ESCO.0722.00359.1314;ESCO.0722.00359.1314b_05931;140;208;68
ESCO.0722.00359;ESCO.0722.00359.0034;ESCO.0722.00359.0034i_04116;25072;25488;416
ESCO.0722.00359;ESCO.0722.00359.0043;ESCO.0722.00359.0043b_04340;533;961;428
ESCO.0722.00359;ESCO.0722.00359.0077;ESCO.0722.00359.0077b_04628;4255;4389;134
ESCO.0722.00359;ESCO.0722.00359.0094;ESCO.0722.00359.0094b_04692;142;870;728
ESCO.0722.00359;ESCO.0722.00359.0104;ESCO.0722.00359.0104b_04724;1694;1918;224
ESCO.0722.00359;ESCO.0722.00359.0122;ESCO.0722.00359.0122b_04756;1;513;512
ESCO.0722.00359;ESCO.0722.00359.0208;ESCO.0722.00359.0208b_04884;336;521;185
ESCO.0722.00359;ESCO.0722.00359.0237;ESCO.0722.00359.0237b_04916;1;183;182
ESCO.0722.00359;ESCO.0722.00359.0267;ESCO.0722.00359.0267b_04948;2;196;194
ESCO.0722.00359;ESCO.0722.00359.0297;ESCO.0722.00359.0297b_04980;2;403;401
ESCO.0722.00359;ESCO.0722.00359.0325;ESCO.0722.00359.0325b_05012;3;380;377
ESCO.0722.00359;ESCO.0722.00359.0416;ESCO.0722.00359.0416b_05108;1;336;335
ESCO.0722.00359;ESCO.0722.00359.0449;ESCO.0722.00359.0449b_05140;251;322;71
ESCO.0722.00359;ESCO.0722.00359.0484;ESCO.0722.00359.0484b_05172;2;205;203
ESCO.0722.00359;ESCO.0722.00359.0522;ESCO.0722.00359.0522b_05204;2;67;65
ESCO.0722.00359;ESCO.0722.00359.0554;ESCO.0722.00359.0554b_05236;3;290;287
ESCO.0722.00359;ESCO.0722.00359.0587;ESCO.0722.00359.0587b_05268;1;63;62
ESCO.0722.00359;ESCO.0722.00359.0619;ESCO.0722.00359.0619b_05300;3;272;269
ESCO.0722.00359;ESCO.0722.00359.0654;ESCO.0722.00359.0654b_05332;96;266;170
ESCO.0722.00359;ESCO.0722.00359.0689;ESCO.0722.00359.0689b_05364;3;263;260
ESCO.0722.00359;ESCO.0722.00359.0725;ESCO.0722.00359.0725b_05396;2;67;65
ESCO.0722.00359;ESCO.0722.00359.0757;ESCO.0722.00359.0757b_05428;3;254;251
ESCO.0722.00359;ESCO.0722.00359.0793;ESCO.0722.00359.0793b_05460;64;249;185
ESCO.0722.00359;ESCO.0722.00359.0831;ESCO.0722.00359.0831b_05492;2;223;221
ESCO.0722.00359;ESCO.0722.00359.0864;ESCO.0722.00359.0864b_05524;3;242;239
ESCO.0722.00359;ESCO.0722.00359.0901;ESCO.0722.00359.0901b_05556;3;239;236
ESCO.0722.00359;ESCO.0722.00359.0937;ESCO.0722.00359.0937b_05588;3;236;233
ESCO.0722.00359;ESCO.0722.00359.0970;ESCO.0722.00359.0970b_05620;1;162;161
ESCO.0722.00359;ESCO.0722.00359.1003;ESCO.0722.00359.1003b_05652;3;125;122
ESCO.0722.00359;ESCO.0722.00359.1039;ESCO.0722.00359.1039b_05684;3;227;224
ESCO.0722.00359;ESCO.0722.00359.1079;ESCO.0722.00359.1079b_05716;1;225;224
ESCO.0722.00359;ESCO.0722.00359.1114;ESCO.0722.00359.1114b_05748;156;224;68
ESCO.0722.00359;ESCO.0722.00359.1150;ESCO.0722.00359.1150b_05780;2;220;218
ESCO.0722.00359;ESCO.0722.00359.1187;ESCO.0722.00359.1187b_05812;2;217;215
ESCO.0722.00359;ESCO.0722.00359.1224;ESCO.0722.00359.1224b_05844;2;214;212
ESCO.0722.00359;ESCO.0722.00359.1256;ESCO.0722.00359.1256b_05876;1;210;209
ESCO.0722.00359;ESCO.0722.00359.1290;ESCO.0722.00359.1290b_05908;3;209;206
ESCO.0722.00359;ESCO.0722.00359.1325;ESCO.0722.00359.1325b_05940;2;208;206
ESCO.0722.00359;ESCO.0722.00359.1365;ESCO.0722.00359.1365b_05972;1;96;95
ESCO.0722.00359;ESCO.0722.00359.0001;ESCO.0722.00359.0001i_00344;398816;399922;1106
ESCO.0722.00359;ESCO.0722.00359.0017;ESCO.0722.00359.0017i_02680;33731;33949;218
ESCO.0722.00359;ESCO.0722.00359.0043;ESCO.0722.00359.0043i_04344;8665;8919;254
ESCO.0722.00359;ESCO.0722.00359.0070;ESCO.0722.00359.0070b_04600;1;126;125
ESCO.0722.00359;ESCO.0722.00359.0086;ESCO.0722.00359.0086b_04664;3;1289;1286
ESCO.0722.00359;ESCO.0722.00359.0124;ESCO.0722.00359.0124b_04760;2;280;278
ESCO.0722.00359;ESCO.0722.00359.0163;ESCO.0722.00359.0163b_04824;2;157;155
ESCO.0722.00359;ESCO.0722.00359.0239;ESCO.0722.00359.0239b_04920;1;258;257
ESCO.0722.00359;ESCO.0722.00359.0271;ESCO.0722.00359.0271b_04952;2;157;155
ESCO.0722.00359;ESCO.0722.00359.0332;ESCO.0722.00359.0332b_05016;1;378;377
ESCO.0722.00359;ESCO.0722.00359.0361;ESCO.0722.00359.0361b_05048;1;360;359
ESCO.0722.00359;ESCO.0722.00359.0453;ESCO.0722.00359.0453b_05144;3;143;140
ESCO.0722.00359;ESCO.0722.00359.0489;ESCO.0722.00359.0489b_05176;1;306;305
ESCO.0722.00359;ESCO.0722.00359.0525;ESCO.0722.00359.0525b_05208;2;295;293
ESCO.0722.00359;ESCO.0722.00359.0557;ESCO.0722.00359.0557b_05240;3;287;284
ESCO.0722.00359;ESCO.0722.00359.0589;ESCO.0722.00359.0589b_05272;2;145;143
ESCO.0722.00359;ESCO.0722.00359.0693;ESCO.0722.00359.0693b_05368;1;261;260
ESCO.0722.00359;ESCO.0722.00359.0729;ESCO.0722.00359.0729b_05400;2;256;254
ESCO.0722.00359;ESCO.0722.00359.0762;ESCO.0722.00359.0762b_05432;1;255;254
ESCO.0722.00359;ESCO.0722.00359.0836;ESCO.0722.00359.0836b_05496;3;245;242
ESCO.0722.00359;ESCO.0722.00359.0868;ESCO.0722.00359.0868b_05528;2;244;242
ESCO.0722.00359;ESCO.0722.00359.0905;ESCO.0722.00359.0905b_05560;1;240;239
ESCO.0722.00359;ESCO.0722.00359.0942;ESCO.0722.00359.0942b_05592;1;237;236
ESCO.0722.00359;ESCO.0722.00359.0974;ESCO.0722.00359.0974b_05624;3;134;131
ESCO.0722.00359;ESCO.0722.00359.1008;ESCO.0722.00359.1008b_05656;3;230;227
ESCO.0722.00359;ESCO.0722.00359.1047;ESCO.0722.00359.1047b_05688;2;229;227
ESCO.0722.00359;ESCO.0722.00359.1083;ESCO.0722.00359.1083b_05720;3;224;221
ESCO.0722.00359;ESCO.0722.00359.1119;ESCO.0722.00359.1119b_05752;2;223;221
ESCO.0722.00359;ESCO.0722.00359.1155;ESCO.0722.00359.1155b_05784;1;219;218
ESCO.0722.00359;ESCO.0722.00359.1191;ESCO.0722.00359.1191b_05816;3;218;215
ESCO.0722.00359;ESCO.0722.00359.1228;ESCO.0722.00359.1228b_05848;3;155;152
ESCO.0722.00359;ESCO.0722.00359.1261;ESCO.0722.00359.1261b_05880;1;210;209
ESCO.0722.00359;ESCO.0722.00359.1332;ESCO.0722.00359.1332b_05944;89;205;116
ESCO.0722.00359;ESCO.0722.00359.1419;ESCO.0722.00359.1419b_06008;1;78;77
ESCO.0722.00359;ESCO.0722.00359.0001;ESCO.0722.00359.0001i_00345;399919;401049;1130
ESCO.0722.00359;ESCO.0722.00359.0011;ESCO.0722.00359.0011i_01785;89394;89789;395
ESCO.0722.00359;ESCO.0722.00359.0043;ESCO.0722.00359.0043i_04345;9039;9239;200
ESCO.0722.00359;ESCO.0722.00359.0048;ESCO.0722.00359.0048i_04441;5124;5771;647
ESCO.0722.00359;ESCO.0722.00359.0070;ESCO.0722.00359.0070i_04601;175;579;404
ESCO.0722.00359;ESCO.0722.00359.0079;ESCO.0722.00359.0079b_04633;16;192;176
ESCO.0722.00359;ESCO.0722.00359.0086;ESCO.0722.00359.0086i_04665;1286;1528;242
ESCO.0722.00359;ESCO.0722.00359.0108;ESCO.0722.00359.0108b_04729;3;200;197
ESCO.0722.00359;ESCO.0722.00359.0140;ESCO.0722.00359.0140b_04793;872;955;83
ESCO.0722.00359;ESCO.0722.00359.0186;ESCO.0722.00359.0186b_04857;70;570;500
ESCO.0722.00359;ESCO.0722.00359.0272;ESCO.0722.00359.0272b_04953;3;422;419
ESCO.0722.00359;ESCO.0722.00359.0300;ESCO.0722.00359.0300b_04985;327;401;74
ESCO.0722.00359;ESCO.0722.00359.0362;ESCO.0722.00359.0362b_05049;2;112;110
ESCO.0722.00359;ESCO.0722.00359.0390;ESCO.0722.00359.0390b_05081;3;161;158
ESCO.0722.00359;ESCO.0722.00359.0422;ESCO.0722.00359.0422b_05113;1;270;269
ESCO.0722.00359;ESCO.0722.00359.0453;ESCO.0722.00359.0453b_05145;136;321;185
ESCO.0722.00359;ESCO.0722.00359.0490;ESCO.0722.00359.0490b_05177;2;304;302
ESCO.0722.00359;ESCO.0722.00359.0526;ESCO.0722.00359.0526b_05209;3;296;293
ESCO.0722.00359;ESCO.0722.00359.0590;ESCO.0722.00359.0590b_05273;2;277;275
ESCO.0722.00359;ESCO.0722.00359.0624;ESCO.0722.00359.0624b_05305;1;270;269
ESCO.0722.00359;ESCO.0722.00359.0695;ESCO.0722.00359.0695b_05369;3;260;257
ESCO.0722.00359;ESCO.0722.00359.0730;ESCO.0722.00359.0730b_05401;2;256;254
ESCO.0722.00359;ESCO.0722.00359.0763;ESCO.0722.00359.0763b_05433;2;253;251
ESCO.0722.00359;ESCO.0722.00359.0799;ESCO.0722.00359.0799b_05465;3;218;215
ESCO.0722.00359;ESCO.0722.00359.0837;ESCO.0722.00359.0837b_05497;3;245;242
ESCO.0722.00359;ESCO.0722.00359.0906;ESCO.0722.00359.0906b_05561;3;152;149
ESCO.0722.00359;ESCO.0722.00359.0943;ESCO.0722.00359.0943b_05593;2;238;236
ESCO.0722.00359;ESCO.0722.00359.0974;ESCO.0722.00359.0974b_05625;124;234;110
ESCO.0722.00359;ESCO.0722.00359.1009;ESCO.0722.00359.1009b_05657;2;232;230
ESCO.0722.00359;ESCO.0722.00359.1048;ESCO.0722.00359.1048b_05689;3;227;224
ESCO.0722.00359;ESCO.0722.00359.1084;ESCO.0722.00359.1084b_05721;3;224;221
ESCO.0722.00359;ESCO.0722.00359.1120;ESCO.0722.00359.1120b_05753;92;223;131
ESCO.0722.00359;ESCO.0722.00359.1156;ESCO.0722.00359.1156b_05785;2;220;218
ESCO.0722.00359;ESCO.0722.00359.1192;ESCO.0722.00359.1192b_05817;1;216;215
ESCO.0722.00359;ESCO.0722.00359.1229;ESCO.0722.00359.1229b_05849;1;213;212
ESCO.0722.00359;ESCO.0722.00359.1262;ESCO.0722.00359.1262b_05881;2;211;209
ESCO.0722.00359;ESCO.0722.00359.1296;ESCO.0722.00359.1296b_05913;1;210;209
ESCO.0722.00359;ESCO.0722.00359.1333;ESCO.0722.00359.1333b_05945;1;207;206
ESCO.0722.00359;ESCO.0722.00359.1375;ESCO.0722.00359.1375b_05977;1;138;137
ESCO.0722.00359;ESCO.0722.00359.0001;ESCO.0722.00359.0001i_00346;401049;402257;1208
ESCO.0722.00359;ESCO.0722.00359.0011;ESCO.0722.00359.0011i_01786;89893;90378;485
ESCO.0722.00359;ESCO.0722.00359.0017;ESCO.0722.00359.0017i_02682;36289;36531;242
ESCO.0722.00359;ESCO.0722.00359.0044;ESCO.0722.00359.0044i_04378;11794;12015;221
ESCO.0722.00359;ESCO.0722.00359.0048;ESCO.0722.00359.0048i_04442;5908;7203;1295
ESCO.0722.00359;ESCO.0722.00359.0063;ESCO.0722.00359.0063b_04570;483;2795;2312
ESCO.0722.00359;ESCO.0722.00359.0070;ESCO.0722.00359.0070i_04602;845;1186;341
ESCO.0722.00359;ESCO.0722.00359.0086;ESCO.0722.00359.0086i_04666;1753;2310;557
ESCO.0722.00359;ESCO.0722.00359.0108;ESCO.0722.00359.0108i_04730;204;479;275
ESCO.0722.00359;ESCO.0722.00359.0124;ESCO.0722.00359.0124b_04762;901;1218;317
ESCO.0722.00359;ESCO.0722.00359.0164;ESCO.0722.00359.0164b_04826;3;707;704
ESCO.0722.00359;ESCO.0722.00359.0187;ESCO.0722.00359.0187b_04858;2;415;413
ESCO.0722.00359;ESCO.0722.00359.0214;ESCO.0722.00359.0214b_04890;2;409;407
ESCO.0722.00359;ESCO.0722.00359.0273;ESCO.0722.00359.0273b_04954;1;72;71
ESCO.0722.00359;ESCO.0722.00359.0333;ESCO.0722.00359.0333b_05018;310;378;68
ESCO.0722.00359;ESCO.0722.00359.0362;ESCO.0722.00359.0362b_05050;109;360;251
ESCO.0722.00359;ESCO.0722.00359.0390;ESCO.0722.00359.0390b_05082;173;346;173
ESCO.0722.00359;ESCO.0722.00359.0423;ESCO.0722.00359.0423b_05114;2;334;332
ESCO.0722.00359;ESCO.0722.00359.0455;ESCO.0722.00359.0455b_05146;3;320;317
ESCO.0722.00359;ESCO.0722.00359.0491;ESCO.0722.00359.0491b_05178;2;304;302
ESCO.0722.00359;ESCO.0722.00359.0527;ESCO.0722.00359.0527b_05210;2;295;293
ESCO.0722.00359;ESCO.0722.00359.0591;ESCO.0722.00359.0591b_05274;2;277;275
ESCO.0722.00359;ESCO.0722.00359.0625;ESCO.0722.00359.0625b_05306;130;270;140
ESCO.0722.00359;ESCO.0722.00359.0661;ESCO.0722.00359.0661b_05338;3;266;263
ESCO.0722.00359;ESCO.0722.00359.0696;ESCO.0722.00359.0696b_05370;2;82;80
ESCO.0722.00359;ESCO.0722.00359.0731;ESCO.0722.00359.0731b_05402;1;258;257
ESCO.0722.00359;ESCO.0722.00359.0764;ESCO.0722.00359.0764b_05434;3;254;251
ESCO.0722.00359;ESCO.0722.00359.0800;ESCO.0722.00359.0800b_05466;86;250;164
ESCO.0722.00359;ESCO.0722.00359.0838;ESCO.0722.00359.0838b_05498;1;246;245
ESCO.0722.00359;ESCO.0722.00359.0870;ESCO.0722.00359.0870b_05530;2;241;239
ESCO.0722.00359;ESCO.0722.00359.0906;ESCO.0722.00359.0906b_05562;167;238;71
ESCO.0722.00359;ESCO.0722.00359.0944;ESCO.0722.00359.0944b_05594;49;237;188
ESCO.0722.00359;ESCO.0722.00359.0975;ESCO.0722.00359.0975b_05626;2;235;233
ESCO.0722.00359;ESCO.0722.00359.1049;ESCO.0722.00359.1049b_05690;1;228;227
ESCO.0722.00359;ESCO.0722.00359.1085;ESCO.0722.00359.1085b_05722;3;224;221
ESCO.0722.00359;ESCO.0722.00359.1121;ESCO.0722.00359.1121b_05754;3;221;218
ESCO.0722.00359;ESCO.0722.00359.1157;ESCO.0722.00359.1157b_05786;3;92;89
ESCO.0722.00359;ESCO.0722.00359.1193;ESCO.0722.00359.1193b_05818;3;215;212
ESCO.0722.00359;ESCO.0722.00359.1230;ESCO.0722.00359.1230b_05850;3;212;209
ESCO.0722.00359;ESCO.0722.00359.1263;ESCO.0722.00359.1263b_05882;1;210;209
ESCO.0722.00359;ESCO.0722.00359.1297;ESCO.0722.00359.1297b_05914;3;209;206
ESCO.0722.00359;ESCO.0722.00359.1334;ESCO.0722.00359.1334b_05946;3;206;203
ESCO.0722.00359;ESCO.0722.00359.0001;ESCO.0722.00359.0001i_00347;402248;402655;407
ESCO.0722.00359;ESCO.0722.00359.0017;ESCO.0722.00359.0017i_02683;36536;36736;200
ESCO.0722.00359;ESCO.0722.00359.0043;ESCO.0722.00359.0043i_04347;9707;10162;455
ESCO.0722.00359;ESCO.0722.00359.0044;ESCO.0722.00359.0044i_04379;11991;13145;1154
ESCO.0722.00359;ESCO.0722.00359.0048;ESCO.0722.00359.0048i_04443;7262;7951;689
ESCO.0722.00359;ESCO.0722.00359.0108;ESCO.0722.00359.0108b_04731;488;1585;1097
ESCO.0722.00359;ESCO.0722.00359.0125;ESCO.0722.00359.0125b_04763;3;800;797
ESCO.0722.00359;ESCO.0722.00359.0188;ESCO.0722.00359.0188b_04859;385;570;185
ESCO.0722.00359;ESCO.0722.00359.0273;ESCO.0722.00359.0273b_04955;81;422;341
ESCO.0722.00359;ESCO.0722.00359.0334;ESCO.0722.00359.0334b_05019;195;377;182
ESCO.0722.00359;ESCO.0722.00359.0391;ESCO.0722.00359.0391b_05083;3;344;341
ESCO.0722.00359;ESCO.0722.00359.0424;ESCO.0722.00359.0424b_05115;1;336;335
ESCO.0722.00359;ESCO.0722.00359.0456;ESCO.0722.00359.0456b_05147;1;321;320
ESCO.0722.00359;ESCO.0722.00359.0493;ESCO.0722.00359.0493b_05179;3;305;302
ESCO.0722.00359;ESCO.0722.00359.0529;ESCO.0722.00359.0529b_05211;3;113;110
ESCO.0722.00359;ESCO.0722.00359.0560;ESCO.0722.00359.0560b_05243;1;288;287
ESCO.0722.00359;ESCO.0722.00359.0592;ESCO.0722.00359.0592b_05275;150;275;125
ESCO.0722.00359;ESCO.0722.00359.0626;ESCO.0722.00359.0626b_05307;3;269;266
ESCO.0722.00359;ESCO.0722.00359.0662;ESCO.0722.00359.0662b_05339;2;265;263
ESCO.0722.00359;ESCO.0722.00359.0696;ESCO.0722.00359.0696b_05371;163;261;98
ESCO.0722.00359;ESCO.0722.00359.0732;ESCO.0722.00359.0732b_05403;3;167;164
ESCO.0722.00359;ESCO.0722.00359.0765;ESCO.0722.00359.0765b_05435;3;254;251
ESCO.0722.00359;ESCO.0722.00359.0802;ESCO.0722.00359.0802b_05467;3;248;245
ESCO.0722.00359;ESCO.0722.00359.0839;ESCO.0722.00359.0839b_05499;1;246;245
ESCO.0722.00359;ESCO.0722.00359.0871;ESCO.0722.00359.0871b_05531;2;241;239
ESCO.0722.00359;ESCO.0722.00359.0907;ESCO.0722.00359.0907b_05563;2;238;236
ESCO.0722.00359;ESCO.0722.00359.0945;ESCO.0722.00359.0945b_05595;1;237;236
ESCO.0722.00359;ESCO.0722.00359.0976;ESCO.0722.00359.0976b_05627;3;233;230
ESCO.0722.00359;ESCO.0722.00359.1050;ESCO.0722.00359.1050b_05691;1;228;227
ESCO.0722.00359;ESCO.0722.00359.1122;ESCO.0722.00359.1122b_05755;2;223;221
ESCO.0722.00359;ESCO.0722.00359.1157;ESCO.0722.00359.1157b_05787;153;221;68
ESCO.0722.00359;ESCO.0722.00359.1194;ESCO.0722.00359.1194b_05819;3;215;212
ESCO.0722.00359;ESCO.0722.00359.1231;ESCO.0722.00359.1231b_05851;2;214;212
ESCO.0722.00359;ESCO.0722.00359.1264;ESCO.0722.00359.1264b_05883;2;211;209
ESCO.0722.00359;ESCO.0722.00359.1298;ESCO.0722.00359.1298b_05915;2;208;206
ESCO.0722.00359;ESCO.0722.00359.1335;ESCO.0722.00359.1335b_05947;3;194;191
ESCO.0722.00359;ESCO.0722.00359.0001;ESCO.0722.00359.0001i_00003;1140;1829;689
ESCO.0722.00359;ESCO.0722.00359.0017;ESCO.0722.00359.0017i_02691;39586;40368;782
ESCO.0722.00359;ESCO.0722.00359.0055;ESCO.0722.00359.0055b_04515;9231;9428;197
ESCO.0722.00359;ESCO.0722.00359.0065;ESCO.0722.00359.0065i_04579;5723;5983;260
ESCO.0722.00359;ESCO.0722.00359.0114;ESCO.0722.00359.0114b_04739;1;711;710
ESCO.0722.00359;ESCO.0722.00359.0130;ESCO.0722.00359.0130b_04771;3;329;326
ESCO.0722.00359;ESCO.0722.00359.0146;ESCO.0722.00359.0146b_04803;772;885;113
ESCO.0722.00359;ESCO.0722.00359.0170;ESCO.0722.00359.0170b_04835;550;639;89
ESCO.0722.00359;ESCO.0722.00359.0194;ESCO.0722.00359.0194b_04867;3;557;554
ESCO.0722.00359;ESCO.0722.00359.0222;ESCO.0722.00359.0222b_04899;60;509;449
ESCO.0722.00359;ESCO.0722.00359.0251;ESCO.0722.00359.0251b_04931;235;450;215
ESCO.0722.00359;ESCO.0722.00359.0278;ESCO.0722.00359.0278b_04963;2;418;416
ESCO.0722.00359;ESCO.0722.00359.0308;ESCO.0722.00359.0308b_04995;2;283;281
ESCO.0722.00359;ESCO.0722.00359.0342;ESCO.0722.00359.0342b_05027;57;374;317
ESCO.0722.00359;ESCO.0722.00359.0432;ESCO.0722.00359.0432b_05123;2;331;329
ESCO.0722.00359;ESCO.0722.00359.0465;ESCO.0722.00359.0465b_05155;57;314;257
ESCO.0722.00359;ESCO.0722.00359.0499;ESCO.0722.00359.0499b_05187;227;301;74
ESCO.0722.00359;ESCO.0722.00359.0536;ESCO.0722.00359.0536b_05219;2;292;290
ESCO.0722.00359;ESCO.0722.00359.0568;ESCO.0722.00359.0568b_05251;137;283;146
ESCO.0722.00359;ESCO.0722.00359.0601;ESCO.0722.00359.0601b_05283;3;275;272
ESCO.0722.00359;ESCO.0722.00359.0637;ESCO.0722.00359.0637b_05315;1;210;209
ESCO.0722.00359;ESCO.0722.00359.0707;ESCO.0722.00359.0707b_05379;178;261;83
ESCO.0722.00359;ESCO.0722.00359.0740;ESCO.0722.00359.0740b_05411;2;256;254
ESCO.0722.00359;ESCO.0722.00359.0812;ESCO.0722.00359.0812b_05475;3;248;245
ESCO.0722.00359;ESCO.0722.00359.0883;ESCO.0722.00359.0883b_05539;2;241;239
ESCO.0722.00359;ESCO.0722.00359.0916;ESCO.0722.00359.0916b_05571;1;240;239
ESCO.0722.00359;ESCO.0722.00359.1022;ESCO.0722.00359.1022b_05667;1;231;230
ESCO.0722.00359;ESCO.0722.00359.1060;ESCO.0722.00359.1060b_05699;1;228;227
ESCO.0722.00359;ESCO.0722.00359.1095;ESCO.0722.00359.1095b_05731;3;224;221
ESCO.0722.00359;ESCO.0722.00359.1130;ESCO.0722.00359.1130b_05763;3;221;218
ESCO.0722.00359;ESCO.0722.00359.1167;ESCO.0722.00359.1167b_05795;1;219;218
ESCO.0722.00359;ESCO.0722.00359.1206;ESCO.0722.00359.1206b_05827;120;215;95
ESCO.0722.00359;ESCO.0722.00359.1239;ESCO.0722.00359.1239b_05859;2;115;113
ESCO.0722.00359;ESCO.0722.00359.1271;ESCO.0722.00359.1271b_05891;3;209;206
ESCO.0722.00359;ESCO.0722.00359.1306;ESCO.0722.00359.1306b_05923;2;208;206
ESCO.0722.00359;ESCO.0722.00359.1343;ESCO.0722.00359.1343b_05955;2;178;176
ESCO.0722.00359;ESCO.0722.00359.0032;ESCO.0722.00359.0032i_04004;102196;102546;350
ESCO.0722.00359;ESCO.0722.00359.0043;ESCO.0722.00359.0043i_04356;17478;17729;251
ESCO.0722.00359;ESCO.0722.00359.0050;ESCO.0722.00359.0050b_04452;2;280;278
ESCO.0722.00359;ESCO.0722.00359.0065;ESCO.0722.00359.0065b_04580;6045;6140;95
ESCO.0722.00359;ESCO.0722.00359.0073;ESCO.0722.00359.0073b_04612;1449;3365;1916
ESCO.0722.00359;ESCO.0722.00359.0099;ESCO.0722.00359.0099i_04708;919;1080;161
ESCO.0722.00359;ESCO.0722.00359.0114;ESCO.0722.00359.0114b_04740;765;1202;437
ESCO.0722.00359;ESCO.0722.00359.0195;ESCO.0722.00359.0195b_04868;46;546;500
ESCO.0722.00359;ESCO.0722.00359.0223;ESCO.0722.00359.0223b_04900;1;276;275
ESCO.0722.00359;ESCO.0722.00359.0279;ESCO.0722.00359.0279b_04964;2;109;107
ESCO.0722.00359;ESCO.0722.00359.0309;ESCO.0722.00359.0309b_04996;1;351;350
ESCO.0722.00359;ESCO.0722.00359.0343;ESCO.0722.00359.0343b_05028;2;358;356
ESCO.0722.00359;ESCO.0722.00359.0371;ESCO.0722.00359.0371b_05060;1;357;356
ESCO.0722.00359;ESCO.0722.00359.0433;ESCO.0722.00359.0433b_05124;1;330;329
ESCO.0722.00359;ESCO.0722.00359.0466;ESCO.0722.00359.0466b_05156;2;316;314
ESCO.0722.00359;ESCO.0722.00359.0500;ESCO.0722.00359.0500b_05188;2;301;299
ESCO.0722.00359;ESCO.0722.00359.0537;ESCO.0722.00359.0537b_05220;3;293;290
ESCO.0722.00359;ESCO.0722.00359.0569;ESCO.0722.00359.0569b_05252;2;163;161
ESCO.0722.00359;ESCO.0722.00359.0602;ESCO.0722.00359.0602b_05284;1;60;59
ESCO.0722.00359;ESCO.0722.00359.0638;ESCO.0722.00359.0638b_05316;3;269;266
ESCO.0722.00359;ESCO.0722.00359.0672;ESCO.0722.00359.0672b_05348;34;264;230
ESCO.0722.00359;ESCO.0722.00359.0741;ESCO.0722.00359.0741b_05412;1;255;254
ESCO.0722.00359;ESCO.0722.00359.0775;ESCO.0722.00359.0775b_05444;1;252;251
ESCO.0722.00359;ESCO.0722.00359.0813;ESCO.0722.00359.0813b_05476;2;127;125
ESCO.0722.00359;ESCO.0722.00359.0847;ESCO.0722.00359.0847b_05508;1;243;242
ESCO.0722.00359;ESCO.0722.00359.0884;ESCO.0722.00359.0884b_05540;1;183;182
ESCO.0722.00359;ESCO.0722.00359.0918;ESCO.0722.00359.0918b_05572;1;102;101
ESCO.0722.00359;ESCO.0722.00359.0954;ESCO.0722.00359.0954b_05604;3;236;233
ESCO.0722.00359;ESCO.0722.00359.0987;ESCO.0722.00359.0987b_05636;130;234;104
ESCO.0722.00359;ESCO.0722.00359.1023;ESCO.0722.00359.1023b_05668;3;230;227
ESCO.0722.00359;ESCO.0722.00359.1061;ESCO.0722.00359.1061b_05700;3;131;128
ESCO.0722.00359;ESCO.0722.00359.1096;ESCO.0722.00359.1096b_05732;2;136;134
ESCO.0722.00359;ESCO.0722.00359.1131;ESCO.0722.00359.1131b_05764;3;221;218
ESCO.0722.00359;ESCO.0722.00359.1169;ESCO.0722.00359.1169b_05796;3;218;215
ESCO.0722.00359;ESCO.0722.00359.1207;ESCO.0722.00359.1207b_05828;127;216;89
ESCO.0722.00359;ESCO.0722.00359.1239;ESCO.0722.00359.1239b_05860;112;213;101
ESCO.0722.00359;ESCO.0722.00359.1272;ESCO.0722.00359.1272b_05892;2;211;209
ESCO.0722.00359;ESCO.0722.00359.1309;ESCO.0722.00359.1309b_05924;2;208;206
ESCO.0722.00359;ESCO.0722.00359.1345;ESCO.0722.00359.1345b_05956;3;206;203
ESCO.0722.00359;ESCO.0722.00359.0010;ESCO.0722.00359.0010i_01541;79802;81238;1436
ESCO.0722.00359;ESCO.0722.00359.0032;ESCO.0722.00359.0032i_04005;102543;103814;1271
ESCO.0722.00359;ESCO.0722.00359.0033;ESCO.0722.00359.0033i_04037;32613;33089;476
ESCO.0722.00359;ESCO.0722.00359.0074;ESCO.0722.00359.0074b_04613;2;706;704
ESCO.0722.00359;ESCO.0722.00359.0171;ESCO.0722.00359.0171b_04837;444;623;179
ESCO.0722.00359;ESCO.0722.00359.0224;ESCO.0722.00359.0224b_04901;2;496;494
ESCO.0722.00359;ESCO.0722.00359.0280;ESCO.0722.00359.0280b_04965;2;418;416
ESCO.0722.00359;ESCO.0722.00359.0311;ESCO.0722.00359.0311b_04997;2;394;392
ESCO.0722.00359;ESCO.0722.00359.0344;ESCO.0722.00359.0344b_05029;3;368;365
ESCO.0722.00359;ESCO.0722.00359.0372;ESCO.0722.00359.0372b_05061;1;330;329
ESCO.0722.00359;ESCO.0722.00359.0434;ESCO.0722.00359.0434b_05125;1;291;290
ESCO.0722.00359;ESCO.0722.00359.0467;ESCO.0722.00359.0467b_05157;3;314;311
ESCO.0722.00359;ESCO.0722.00359.0501;ESCO.0722.00359.0501b_05189;3;104;101
ESCO.0722.00359;ESCO.0722.00359.0538;ESCO.0722.00359.0538b_05221;1;99;98
ESCO.0722.00359;ESCO.0722.00359.0569;ESCO.0722.00359.0569b_05253;180;284;104
ESCO.0722.00359;ESCO.0722.00359.0602;ESCO.0722.00359.0602b_05285;57;272;215
ESCO.0722.00359;ESCO.0722.00359.0639;ESCO.0722.00359.0639b_05317;1;270;269
ESCO.0722.00359;ESCO.0722.00359.0673;ESCO.0722.00359.0673b_05349;1;264;263
ESCO.0722.00359;ESCO.0722.00359.0709;ESCO.0722.00359.0709b_05381;1;261;260
ESCO.0722.00359;ESCO.0722.00359.0742;ESCO.0722.00359.0742b_05413;3;257;254
ESCO.0722.00359;ESCO.0722.00359.0813;ESCO.0722.00359.0813b_05477;124;249;125
ESCO.0722.00359;ESCO.0722.00359.0848;ESCO.0722.00359.0848b_05509;3;245;242
ESCO.0722.00359;ESCO.0722.00359.0885;ESCO.0722.00359.0885b_05541;124;240;116
ESCO.0722.00359;ESCO.0722.00359.0918;ESCO.0722.00359.0918b_05573;92;238;146
ESCO.0722.00359;ESCO.0722.00359.0955;ESCO.0722.00359.0955b_05605;3;236;233
ESCO.0722.00359;ESCO.0722.00359.0988;ESCO.0722.00359.0988b_05637;3;233;230
ESCO.0722.00359;ESCO.0722.00359.1024;ESCO.0722.00359.1024b_05669;1;228;227
ESCO.0722.00359;ESCO.0722.00359.1097;ESCO.0722.00359.1097b_05733;2;223;221
ESCO.0722.00359;ESCO.0722.00359.1132;ESCO.0722.00359.1132b_05765;125;220;95
ESCO.0722.00359;ESCO.0722.00359.1171;ESCO.0722.00359.1171b_05797;1;219;218
ESCO.0722.00359;ESCO.0722.00359.1208;ESCO.0722.00359.1208b_05829;3;215;212
ESCO.0722.00359;ESCO.0722.00359.1240;ESCO.0722.00359.1240b_05861;2;214;212
ESCO.0722.00359;ESCO.0722.00359.1274;ESCO.0722.00359.1274b_05893;3;209;206
ESCO.0722.00359;ESCO.0722.00359.1310;ESCO.0722.00359.1310b_05925;1;114;113
ESCO.0722.00359;ESCO.0722.00359.1346;ESCO.0722.00359.1346b_05957;3;206;203
ESCO.0722.00359;ESCO.0722.00359.0017;ESCO.0722.00359.0017i_02673;30777;30956;179
ESCO.0722.00359;ESCO.0722.00359.0020;ESCO.0722.00359.0020i_02865;50517;52049;1532
ESCO.0722.00359;ESCO.0722.00359.0025;ESCO.0722.00359.0025i_03153;60375;60896;521
ESCO.0722.00359;ESCO.0722.00359.0054;ESCO.0722.00359.0054i_04497;1070;1915;845
ESCO.0722.00359;ESCO.0722.00359.0076;ESCO.0722.00359.0076b_04625;4249;4671;422
ESCO.0722.00359;ESCO.0722.00359.0104;ESCO.0722.00359.0104b_04721;3;284;281
ESCO.0722.00359;ESCO.0722.00359.0120;ESCO.0722.00359.0120b_04753;31;525;494
ESCO.0722.00359;ESCO.0722.00359.0158;ESCO.0722.00359.0158b_04817;2;232;230
ESCO.0722.00359;ESCO.0722.00359.0206;ESCO.0722.00359.0206b_04881;67;522;455
ESCO.0722.00359;ESCO.0722.00359.0235;ESCO.0722.00359.0235b_04913;3;437;434
ESCO.0722.00359;ESCO.0722.00359.0354;ESCO.0722.00359.0354b_05041;109;363;254
ESCO.0722.00359;ESCO.0722.00359.0411;ESCO.0722.00359.0411b_05105;3;179;176
ESCO.0722.00359;ESCO.0722.00359.0481;ESCO.0722.00359.0481b_05169;3;308;305
ESCO.0722.00359;ESCO.0722.00359.0616;ESCO.0722.00359.0616b_05297;1;270;269
ESCO.0722.00359;ESCO.0722.00359.0651;ESCO.0722.00359.0651b_05329;1;219;218
ESCO.0722.00359;ESCO.0722.00359.0687;ESCO.0722.00359.0687b_05361;3;92;89
ESCO.0722.00359;ESCO.0722.00359.0722;ESCO.0722.00359.0722b_05393;2;259;257
ESCO.0722.00359;ESCO.0722.00359.0753;ESCO.0722.00359.0753b_05425;2;121;119
ESCO.0722.00359;ESCO.0722.00359.0828;ESCO.0722.00359.0828b_05489;3;248;245
ESCO.0722.00359;ESCO.0722.00359.0861;ESCO.0722.00359.0861b_05521;3;242;239
ESCO.0722.00359;ESCO.0722.00359.0898;ESCO.0722.00359.0898b_05553;149;241;92
ESCO.0722.00359;ESCO.0722.00359.0967;ESCO.0722.00359.0967b_05617;1;234;233
ESCO.0722.00359;ESCO.0722.00359.1000;ESCO.0722.00359.1000b_05649;3;206;203
ESCO.0722.00359;ESCO.0722.00359.1036;ESCO.0722.00359.1036b_05681;46;228;182
ESCO.0722.00359;ESCO.0722.00359.1075;ESCO.0722.00359.1075b_05713;3;224;221
ESCO.0722.00359;ESCO.0722.00359.1112;ESCO.0722.00359.1112b_05745;1;222;221
ESCO.0722.00359;ESCO.0722.00359.1147;ESCO.0722.00359.1147b_05777;3;221;218
ESCO.0722.00359;ESCO.0722.00359.1183;ESCO.0722.00359.1183b_05809;1;216;215
ESCO.0722.00359;ESCO.0722.00359.1221;ESCO.0722.00359.1221b_05841;113;214;101
ESCO.0722.00359;ESCO.0722.00359.1253;ESCO.0722.00359.1253b_05873;2;106;104
ESCO.0722.00359;ESCO.0722.00359.1286;ESCO.0722.00359.1286b_05905;1;210;209
ESCO.0722.00359;ESCO.0722.00359.1322;ESCO.0722.00359.1322b_05937;3;206;203
ESCO.0722.00359;ESCO.0722.00359.1362;ESCO.0722.00359.1362b_05969;3;164;161
ESCO.0722.00359;ESCO.0722.00359.0017;ESCO.0722.00359.0017i_02674;31299;31787;488
ESCO.0722.00359;ESCO.0722.00359.0020;ESCO.0722.00359.0020i_02866;52071;52565;494
ESCO.0722.00359;ESCO.0722.00359.0034;ESCO.0722.00359.0034b_04082;3;869;866
ESCO.0722.00359;ESCO.0722.00359.0104;ESCO.0722.00359.0104i_04722;585;800;215
ESCO.0722.00359;ESCO.0722.00359.0120;ESCO.0722.00359.0120b_04754;665;1345;680
ESCO.0722.00359;ESCO.0722.00359.0181;ESCO.0722.00359.0181b_04850;2;241;239
ESCO.0722.00359;ESCO.0722.00359.0207;ESCO.0722.00359.0207b_04882;3;524;521
ESCO.0722.00359;ESCO.0722.00359.0236;ESCO.0722.00359.0236b_04914;2;271;269
ESCO.0722.00359;ESCO.0722.00359.0265;ESCO.0722.00359.0265b_04946;3;434;431
ESCO.0722.00359;ESCO.0722.00359.0295;ESCO.0722.00359.0295b_04978;241;408;167
ESCO.0722.00359;ESCO.0722.00359.0324;ESCO.0722.00359.0324b_05010;1;255;254
ESCO.0722.00359;ESCO.0722.00359.0355;ESCO.0722.00359.0355b_05042;108;314;206
ESCO.0722.00359;ESCO.0722.00359.0412;ESCO.0722.00359.0412b_05106;3;338;335
ESCO.0722.00359;ESCO.0722.00359.0448;ESCO.0722.00359.0448b_05138;3;323;320
ESCO.0722.00359;ESCO.0722.00359.0482;ESCO.0722.00359.0482b_05170;61;267;206
ESCO.0722.00359;ESCO.0722.00359.0585;ESCO.0722.00359.0585b_05266;2;280;278
ESCO.0722.00359;ESCO.0722.00359.0617;ESCO.0722.00359.0617b_05298;2;271;269
ESCO.0722.00359;ESCO.0722.00359.0687;ESCO.0722.00359.0687b_05362;192;263;71
ESCO.0722.00359;ESCO.0722.00359.0723;ESCO.0722.00359.0723b_05394;3;107;104
ESCO.0722.00359;ESCO.0722.00359.0755;ESCO.0722.00359.0755b_05426;3;254;251
ESCO.0722.00359;ESCO.0722.00359.0829;ESCO.0722.00359.0829b_05490;2;247;245
ESCO.0722.00359;ESCO.0722.00359.0862;ESCO.0722.00359.0862b_05522;2;244;242
ESCO.0722.00359;ESCO.0722.00359.0899;ESCO.0722.00359.0899b_05554;1;222;221
ESCO.0722.00359;ESCO.0722.00359.0968;ESCO.0722.00359.0968b_05618;75;233;158
ESCO.0722.00359;ESCO.0722.00359.1001;ESCO.0722.00359.1001b_05650;2;232;230
ESCO.0722.00359;ESCO.0722.00359.1037;ESCO.0722.00359.1037b_05682;2;229;227
ESCO.0722.00359;ESCO.0722.00359.1077;ESCO.0722.00359.1077b_05714;3;224;221
ESCO.0722.00359;ESCO.0722.00359.1113;ESCO.0722.00359.1113b_05746;2;223;221
ESCO.0722.00359;ESCO.0722.00359.1148;ESCO.0722.00359.1148b_05778;1;219;218
ESCO.0722.00359;ESCO.0722.00359.1184;ESCO.0722.00359.1184b_05810;2;217;215
ESCO.0722.00359;ESCO.0722.00359.1222;ESCO.0722.00359.1222b_05842;2;214;212
ESCO.0722.00359;ESCO.0722.00359.1254;ESCO.0722.00359.1254b_05874;1;210;209
ESCO.0722.00359;ESCO.0722.00359.1287;ESCO.0722.00359.1287b_05906;3;209;206
ESCO.0722.00359;ESCO.0722.00359.1323;ESCO.0722.00359.1323b_05938;1;171;170
ESCO.0722.00359;ESCO.0722.00359.1363;ESCO.0722.00359.1363b_05970;2;160;158
ESCO.0722.00359;ESCO.0722.00359.0032;ESCO.0722.00359.0032i_03955;49323;49886;563
ESCO.0722.00359;ESCO.0722.00359.0054;ESCO.0722.00359.0054i_04499;4639;4857;218
ESCO.0722.00359;ESCO.0722.00359.0093;ESCO.0722.00359.0093b_04691;1883;2527;644
ESCO.0722.00359;ESCO.0722.00359.0104;ESCO.0722.00359.0104i_04723;1447;1707;260
ESCO.0722.00359;ESCO.0722.00359.0159;ESCO.0722.00359.0159b_04819;3;746;743
ESCO.0722.00359;ESCO.0722.00359.0181;ESCO.0722.00359.0181b_04851;423;581;158
ESCO.0722.00359;ESCO.0722.00359.0208;ESCO.0722.00359.0208b_04883;2;325;323
ESCO.0722.00359;ESCO.0722.00359.0236;ESCO.0722.00359.0236b_04915;249;467;218
ESCO.0722.00359;ESCO.0722.00359.0266;ESCO.0722.00359.0266b_04947;2;433;431
ESCO.0722.00359;ESCO.0722.00359.0296;ESCO.0722.00359.0296b_04979;274;405;131
ESCO.0722.00359;ESCO.0722.00359.0324;ESCO.0722.00359.0324b_05011;302;382;80
ESCO.0722.00359;ESCO.0722.00359.0384;ESCO.0722.00359.0384b_05075;1;348;347
ESCO.0722.00359;ESCO.0722.00359.0415;ESCO.0722.00359.0415b_05107;239;337;98
ESCO.0722.00359;ESCO.0722.00359.0483;ESCO.0722.00359.0483b_05171;9;308;299
ESCO.0722.00359;ESCO.0722.00359.0519;ESCO.0722.00359.0519b_05203;1;297;296
ESCO.0722.00359;ESCO.0722.00359.0553;ESCO.0722.00359.0553b_05235;3;290;287
ESCO.0722.00359;ESCO.0722.00359.0586;ESCO.0722.00359.0586b_05267;3;278;275
ESCO.0722.00359;ESCO.0722.00359.0618;ESCO.0722.00359.0618b_05299;3;272;269
ESCO.0722.00359;ESCO.0722.00359.0653;ESCO.0722.00359.0653b_05331;52;267;215
ESCO.0722.00359;ESCO.0722.00359.0688;ESCO.0722.00359.0688b_05363;1;261;260
ESCO.0722.00359;ESCO.0722.00359.0756;ESCO.0722.00359.0756b_05427;2;253;251
ESCO.0722.00359;ESCO.0722.00359.0792;ESCO.0722.00359.0792b_05459;2;250;248
ESCO.0722.00359;ESCO.0722.00359.0830;ESCO.0722.00359.0830b_05491;3;248;245
ESCO.0722.00359;ESCO.0722.00359.0863;ESCO.0722.00359.0863b_05523;106;243;137
ESCO.0722.00359;ESCO.0722.00359.0900;ESCO.0722.00359.0900b_05555;1;240;239
ESCO.0722.00359;ESCO.0722.00359.0936;ESCO.0722.00359.0936b_05587;2;238;236
ESCO.0722.00359;ESCO.0722.00359.0969;ESCO.0722.00359.0969b_05619;2;235;233
ESCO.0722.00359;ESCO.0722.00359.1002;ESCO.0722.00359.1002b_05651;1;231;230
ESCO.0722.00359;ESCO.0722.00359.1038;ESCO.0722.00359.1038b_05683;3;227;224
ESCO.0722.00359;ESCO.0722.00359.1078;ESCO.0722.00359.1078b_05715;1;225;224
ESCO.0722.00359;ESCO.0722.00359.1114;ESCO.0722.00359.1114b_05747;1;159;158
ESCO.0722.00359;ESCO.0722.00359.1149;ESCO.0722.00359.1149b_05779;2;220;218
ESCO.0722.00359;ESCO.0722.00359.1185;ESCO.0722.00359.1185b_05811;2;217;215
ESCO.0722.00359;ESCO.0722.00359.1223;ESCO.0722.00359.1223b_05843;2;214;212
ESCO.0722.00359;ESCO.0722.00359.1255;ESCO.0722.00359.1255b_05875;2;211;209
ESCO.0722.00359;ESCO.0722.00359.1289;ESCO.0722.00359.1289b_05907;2;208;206
ESCO.0722.00359;ESCO.0722.00359.1324;ESCO.0722.00359.1324b_05939;3;206;203
ESCO.0722.00375;ESCO.0722.00375.0009;ESCO.0722.00375.0009i_01305;170387;170785;398
ESCO.0722.00375;ESCO.0722.00375.0011;ESCO.0722.00375.0011i_01369;62956;63507;551
ESCO.0722.00375;ESCO.0722.00375.0016;ESCO.0722.00375.0016i_01721;18265;19455;1190
ESCO.0722.00375;ESCO.0722.00375.0018;ESCO.0722.00375.0018i_02009;78941;79798;857
ESCO.0722.00375;ESCO.0722.00375.0027;ESCO.0722.00375.0027b_02777;71794;74973;3179
ESCO.0722.00375;ESCO.0722.00375.0048;ESCO.0722.00375.0048i_03449;27092;27295;203
ESCO.0722.00375;ESCO.0722.00375.0298;ESCO.0722.00375.0298b_04857;63;212;149
ESCO.0722.00375;ESCO.0722.00375.0351;ESCO.0722.00375.0351b_04889;2;133;131
ESCO.0722.00375;ESCO.0722.00375.0417;ESCO.0722.00375.0417b_04921;1;84;83
ESCO.0722.00375;ESCO.0722.00375.0003;ESCO.0722.00375.0003b_00232;3;986;983
ESCO.0722.00375;ESCO.0722.00375.0005;ESCO.0722.00375.0005i_00840;132544;133020;476
ESCO.0722.00375;ESCO.0722.00375.0046;ESCO.0722.00375.0046b_03368;54656;54898;242
ESCO.0722.00375;ESCO.0722.00375.0059;ESCO.0722.00375.0059i_03880;21662;22297;635
ESCO.0722.00375;ESCO.0722.00375.0281;ESCO.0722.00375.0281b_04840;2;229;227
ESCO.0722.00375;ESCO.0722.00375.0318;ESCO.0722.00375.0318b_04872;75;206;131
ESCO.0722.00375;ESCO.0722.00375.0382;ESCO.0722.00375.0382b_04904;3;74;71
ESCO.0722.00375;ESCO.0722.00375.0016;ESCO.0722.00375.0016b_01705;2;622;620
ESCO.0722.00375;ESCO.0722.00375.0143;ESCO.0722.00375.0143b_04681;137;604;467
ESCO.0722.00375;ESCO.0722.00375.0182;ESCO.0722.00375.0182b_04745;1;153;152
ESCO.0722.00375;ESCO.0722.00375.0211;ESCO.0722.00375.0211b_04777;14;376;362
ESCO.0722.00375;ESCO.0722.00375.0282;ESCO.0722.00375.0282b_04841;2;229;227
ESCO.0722.00375;ESCO.0722.00375.0320;ESCO.0722.00375.0320b_04873;3;206;203
ESCO.0722.00375;ESCO.0722.00375.0384;ESCO.0722.00375.0384b_04905;29;109;80
ESCO.0722.00375;ESCO.0722.00375.0447;ESCO.0722.00375.0447b_04937;2;61;59
ESCO.0722.00375;ESCO.0722.00375.0016;ESCO.0722.00375.0016i_01706;1328;1459;131
ESCO.0722.00375;ESCO.0722.00375.0019;ESCO.0722.00375.0019i_02122;72331;72603;272
ESCO.0722.00375;ESCO.0722.00375.0143;ESCO.0722.00375.0143i_04682;607;987;380
ESCO.0722.00375;ESCO.0722.00375.0182;ESCO.0722.00375.0182b_04746;353;613;260
ESCO.0722.00375;ESCO.0722.00375.0242;ESCO.0722.00375.0242b_04810;2;127;125
ESCO.0722.00375;ESCO.0722.00375.0283;ESCO.0722.00375.0283b_04842;1;228;227
ESCO.0722.00375;ESCO.0722.00375.0048;ESCO.0722.00375.0048i_03453;29784;29957;173
ESCO.0722.00375;ESCO.0722.00375.0074;ESCO.0722.00375.0074b_04221;3;713;710
ESCO.0722.00375;ESCO.0722.00375.0075;ESCO.0722.00375.0075b_04253;20311;21291;980
ESCO.0722.00375;ESCO.0722.00375.0137;ESCO.0722.00375.0137b_04669;1713;1781;68
ESCO.0722.00375;ESCO.0722.00375.0173;ESCO.0722.00375.0173b_04733;3;68;65
ESCO.0722.00375;ESCO.0722.00375.0265;ESCO.0722.00375.0265b_04829;3;239;236
ESCO.0722.00375;ESCO.0722.00375.0302;ESCO.0722.00375.0302b_04861;1;216;215
ESCO.0722.00375;ESCO.0722.00375.0357;ESCO.0722.00375.0357b_04893;3;128;125
ESCO.0722.00375;ESCO.0722.00375.0423;ESCO.0722.00375.0423b_04925;3;80;77
ESCO.0722.00375;ESCO.0722.00375.0011;ESCO.0722.00375.0011i_01374;69278;70666;1388
ESCO.0722.00375;ESCO.0722.00375.0033;ESCO.0722.00375.0033b_02846;1;1293;1292
ESCO.0722.00375;ESCO.0722.00375.0048;ESCO.0722.00375.0048i_03454;29954;30748;794
ESCO.0722.00375;ESCO.0722.00375.0269;ESCO.0722.00375.0269b_04830;2;235;233
ESCO.0722.00375;ESCO.0722.00375.0303;ESCO.0722.00375.0303b_04862;2;214;212
ESCO.0722.00375;ESCO.0722.00375.0425;ESCO.0722.00375.0425b_04926;3;77;74
ESCO.0722.00375;ESCO.0722.00375.0005;ESCO.0722.00375.0005i_00831;127246;127542;296
ESCO.0722.00375;ESCO.0722.00375.0011;ESCO.0722.00375.0011i_01375;70679;73921;3242
ESCO.0722.00375;ESCO.0722.00375.0011;ESCO.0722.00375.0011i_01407;109876;111045;1169
ESCO.0722.00375;ESCO.0722.00375.0048;ESCO.0722.00375.0048i_03455;30783;31280;497
ESCO.0722.00375;ESCO.0722.00375.0074;ESCO.0722.00375.0074i_04223;3786;5558;1772
ESCO.0722.00375;ESCO.0722.00375.0200;ESCO.0722.00375.0200b_04767;1;444;443
ESCO.0722.00375;ESCO.0722.00375.0270;ESCO.0722.00375.0270b_04831;3;233;230
ESCO.0722.00375;ESCO.0722.00375.0304;ESCO.0722.00375.0304b_04863;3;212;209
ESCO.0722.00375;ESCO.0722.00375.0011;ESCO.0722.00375.0011i_01367;61277;61753;476
ESCO.0722.00375;ESCO.0722.00375.0016;ESCO.0722.00375.0016i_01719;14971;16644;1673
ESCO.0722.00375;ESCO.0722.00375.0046;ESCO.0722.00375.0046b_03319;33;224;191
ESCO.0722.00375;ESCO.0722.00375.0048;ESCO.0722.00375.0048i_03447;26008;26883;875
ESCO.0722.00375;ESCO.0722.00375.0058;ESCO.0722.00375.0058i_03831;11756;12166;410
ESCO.0722.00375;ESCO.0722.00375.0085;ESCO.0722.00375.0085i_04407;9627;10061;434
ESCO.0722.00375;ESCO.0722.00375.0090;ESCO.0722.00375.0090b_04471;10318;10566;248
ESCO.0722.00375;ESCO.0722.00375.0192;ESCO.0722.00375.0192b_04759;3;545;542
ESCO.0722.00375;ESCO.0722.00375.0256;ESCO.0722.00375.0256b_04823;1;243;242
ESCO.0722.00375;ESCO.0722.00375.0296;ESCO.0722.00375.0296b_04855;50;217;167
ESCO.0722.00375;ESCO.0722.00375.0346;ESCO.0722.00375.0346b_04887;1;147;146
ESCO.0722.00375;ESCO.0722.00375.0059;ESCO.0722.00375.0059i_03889;26464;26814;350
ESCO.0722.00375;ESCO.0722.00375.0085;ESCO.0722.00375.0085i_04401;1773;2642;869
ESCO.0722.00375;ESCO.0722.00375.0118;ESCO.0722.00375.0118i_04625;545;850;305
ESCO.0722.00375;ESCO.0722.00375.0146;ESCO.0722.00375.0146b_04689;2;139;137
ESCO.0722.00375;ESCO.0722.00375.0218;ESCO.0722.00375.0218b_04785;1;363;362
ESCO.0722.00375;ESCO.0722.00375.0250;ESCO.0722.00375.0250b_04817;1;252;251
ESCO.0722.00375;ESCO.0722.00375.0289;ESCO.0722.00375.0289b_04849;157;222;65
ESCO.0722.00375;ESCO.0722.00375.0401;ESCO.0722.00375.0401b_04913;2;100;98
ESCO.0722.00375;ESCO.0722.00375.0083;ESCO.0722.00375.0083b_04370;2;214;212
ESCO.0722.00375;ESCO.0722.00375.0085;ESCO.0722.00375.0085i_04402;2642;3805;1163
ESCO.0722.00375;ESCO.0722.00375.0109;ESCO.0722.00375.0109b_04594;4181;4432;251
ESCO.0722.00375;ESCO.0722.00375.0118;ESCO.0722.00375.0118i_04626;878;2092;1214
ESCO.0722.00375;ESCO.0722.00375.0251;ESCO.0722.00375.0251b_04818;3;248;245
ESCO.0722.00375;ESCO.0722.00375.0290;ESCO.0722.00375.0290b_04850;2;85;83
ESCO.0722.00375;ESCO.0722.00375.0059;ESCO.0722.00375.0059i_03886;25180;25833;653
ESCO.0722.00375;ESCO.0722.00375.0130;ESCO.0722.00375.0130i_04654;475;987;512
ESCO.0722.00375;ESCO.0722.00375.0287;ESCO.0722.00375.0287b_04846;53;223;170
ESCO.0722.00375;ESCO.0722.00375.0327;ESCO.0722.00375.0327b_04878;2;61;59
ESCO.0722.00375;ESCO.0722.00375.0130;ESCO.0722.00375.0130b_04655;1379;1825;446
ESCO.0722.00375;ESCO.0722.00375.0216;ESCO.0722.00375.0216b_04783;2;106;104
ESCO.0722.00375;ESCO.0722.00375.0288;ESCO.0722.00375.0288b_04847;3;221;218
ESCO.0722.00375;ESCO.0722.00375.0399;ESCO.0722.00375.0399b_04911;1;72;71
ESCO.0722.00375;ESCO.0722.00375.0016;ESCO.0722.00375.0016i_01712;8714;9187;473
ESCO.0722.00375;ESCO.0722.00375.0073;ESCO.0722.00375.0073i_04208;12126;13388;1262
ESCO.0722.00375;ESCO.0722.00375.0085;ESCO.0722.00375.0085b_04400;463;1740;1277
ESCO.0722.00375;ESCO.0722.00375.0087;ESCO.0722.00375.0087i_04432;5059;5493;434
ESCO.0722.00375;ESCO.0722.00375.0101;ESCO.0722.00375.0101b_04560;5210;5326;116
ESCO.0722.00375;ESCO.0722.00375.0118;ESCO.0722.00375.0118b_04624;2;433;431
ESCO.0722.00375;ESCO.0722.00375.0289;ESCO.0722.00375.0289b_04848;2;109;107
ESCO.0722.00375;ESCO.0722.00375.0400;ESCO.0722.00375.0400b_04912;3;104;101
ESCO.0722.00375;ESCO.0722.00375.0011;ESCO.0722.00375.0011i_01368;61814;62956;1142
ESCO.0722.00375;ESCO.0722.00375.0048;ESCO.0722.00375.0048i_03448;26880;27095;215
ESCO.0722.00375;ESCO.0722.00375.0058;ESCO.0722.00375.0058i_03832;12197;12379;182
ESCO.0722.00375;ESCO.0722.00375.0105;ESCO.0722.00375.0105b_04568;910;1389;479
ESCO.0722.00375;ESCO.0722.00375.0193;ESCO.0722.00375.0193b_04760;3;530;527
ESCO.0722.00375;ESCO.0722.00375.0297;ESCO.0722.00375.0297b_04856;2;178;176
ESCO.0722.00375;ESCO.0722.00375.0348;ESCO.0722.00375.0348b_04888;3;143;140
ESCO.0722.00375;ESCO.0722.00375.0005;ESCO.0722.00375.0005i_00802;102838;103335;497
ESCO.0722.00375;ESCO.0722.00375.0019;ESCO.0722.00375.0019i_02050;6554;6892;338
ESCO.0722.00375;ESCO.0722.00375.0025;ESCO.0722.00375.0025i_02626;83220;84170;950
ESCO.0722.00375;ESCO.0722.00375.0057;ESCO.0722.00375.0057b_03778;113;865;752
ESCO.0722.00375;ESCO.0722.00375.0071;ESCO.0722.00375.0071b_04162;23634;23807;173
ESCO.0722.00375;ESCO.0722.00375.0083;ESCO.0722.00375.0083b_04386;15275;15805;530
ESCO.0722.00375;ESCO.0722.00375.0308;ESCO.0722.00375.0308b_04866;3;212;209
ESCO.0722.00375;ESCO.0722.00375.0432;ESCO.0722.00375.0432b_04930;2;73;71
ESCO.0722.00375;ESCO.0722.00375.0019;ESCO.0722.00375.0019i_02051;6941;8311;1370
ESCO.0722.00375;ESCO.0722.00375.0043;ESCO.0722.00375.0043b_03267;57336;57458;122
ESCO.0722.00375;ESCO.0722.00375.0274;ESCO.0722.00375.0274b_04835;3;230;227
ESCO.0722.00375;ESCO.0722.00375.0309;ESCO.0722.00375.0309b_04867;2;211;209
ESCO.0722.00375;ESCO.0722.00375.0026;ESCO.0722.00375.0026b_02628;40;696;656
ESCO.0722.00375;ESCO.0722.00375.0041;ESCO.0722.00375.0041i_03204;40531;40833;302
ESCO.0722.00375;ESCO.0722.00375.0044;ESCO.0722.00375.0044b_03268;27;545;518
ESCO.0722.00375;ESCO.0722.00375.0076;ESCO.0722.00375.0076i_04260;6738;7739;1001
ESCO.0722.00375;ESCO.0722.00375.0178;ESCO.0722.00375.0178b_04740;3;242;239
ESCO.0722.00375;ESCO.0722.00375.0311;ESCO.0722.00375.0311b_04868;39;209;170
ESCO.0722.00375;ESCO.0722.00375.0434;ESCO.0722.00375.0434b_04932;3;71;68
ESCO.0722.00375;ESCO.0722.00375.0011;ESCO.0722.00375.0011i_01408;110996;111409;413
ESCO.0722.00375;ESCO.0722.00375.0021;ESCO.0722.00375.0021b_02272;110651;111487;836
ESCO.0722.00375;ESCO.0722.00375.0022;ESCO.0722.00375.0022i_02304;34707;35480;773
ESCO.0722.00375;ESCO.0722.00375.0048;ESCO.0722.00375.0048i_03456;31724;33154;1430
ESCO.0722.00375;ESCO.0722.00375.0175;ESCO.0722.00375.0175b_04736;3;707;704
ESCO.0722.00375;ESCO.0722.00375.0271;ESCO.0722.00375.0271b_04832;17;139;122
ESCO.0722.00375;ESCO.0722.00375.0011;ESCO.0722.00375.0011i_01377;74612;75442;830
ESCO.0722.00375;ESCO.0722.00375.0017;ESCO.0722.00375.0017i_01921;107527;107661;134
ESCO.0722.00375;ESCO.0722.00375.0022;ESCO.0722.00375.0022i_02305;35531;35938;407
ESCO.0722.00375;ESCO.0722.00375.0048;ESCO.0722.00375.0048i_03457;33315;34442;1127
ESCO.0722.00375;ESCO.0722.00375.0056;ESCO.0722.00375.0056b_03777;34321;34866;545
ESCO.0722.00375;ESCO.0722.00375.0106;ESCO.0722.00375.0106b_04577;4495;4683;188
ESCO.0722.00375;ESCO.0722.00375.0176;ESCO.0722.00375.0176b_04737;2;640;638
ESCO.0722.00375;ESCO.0722.00375.0202;ESCO.0722.00375.0202b_04769;1;432;431
ESCO.0722.00375;ESCO.0722.00375.0233;ESCO.0722.00375.0233b_04801;174;299;125
ESCO.0722.00375;ESCO.0722.00375.0271;ESCO.0722.00375.0271b_04833;159;233;74
ESCO.0722.00375;ESCO.0722.00375.0307;ESCO.0722.00375.0307b_04865;146;211;65
ESCO.0722.00375;ESCO.0722.00375.0371;ESCO.0722.00375.0371b_04897;3;113;110
ESCO.0722.00375;ESCO.0722.00375.0025;ESCO.0722.00375.0025b_02539;84;479;395
ESCO.0722.00375;ESCO.0722.00375.0392;ESCO.0722.00375.0392b_04907;1;108;107
ESCO.0722.00375;ESCO.0722.00375.0069;ESCO.0722.00375.0069b_04108;57;2030;1973
ESCO.0722.00375;ESCO.0722.00375.0087;ESCO.0722.00375.0087b_04428;26;181;155
ESCO.0722.00375;ESCO.0722.00375.0090;ESCO.0722.00375.0090b_04460;1;351;350
ESCO.0722.00375;ESCO.0722.00375.0144;ESCO.0722.00375.0144b_04684;181;681;500
ESCO.0722.00375;ESCO.0722.00375.0213;ESCO.0722.00375.0213b_04780;224;373;149
ESCO.0722.00375;ESCO.0722.00375.0286;ESCO.0722.00375.0286b_04844;3;224;221
ESCO.0722.00375;ESCO.0722.00375.0325;ESCO.0722.00375.0325b_04876;2;190;188
ESCO.0722.00375;ESCO.0722.00375.0393;ESCO.0722.00375.0393b_04908;2;106;104
ESCO.0722.00375;ESCO.0722.00375.0069;ESCO.0722.00375.0069i_04109;2117;2434;317
ESCO.0722.00375;ESCO.0722.00375.0287;ESCO.0722.00375.0287b_04845;2;88;86
ESCO.0722.00375;ESCO.0722.00375.0326;ESCO.0722.00375.0326b_04877;4;189;185
ESCO.0722.00375;ESCO.0722.00375.0009;ESCO.0722.00375.0009i_01302;168357;168524;167
ESCO.0722.00375;ESCO.0722.00375.0011;ESCO.0722.00375.0011i_01366;59275;61284;2009
ESCO.0722.00375;ESCO.0722.00375.0048;ESCO.0722.00375.0048i_03446;25770;26015;245
ESCO.0722.00375;ESCO.0722.00375.0052;ESCO.0722.00375.0052i_03638;35370;37208;1838
ESCO.0722.00375;ESCO.0722.00375.0072;ESCO.0722.00375.0072i_04182;17761;18048;287
ESCO.0722.00375;ESCO.0722.00375.0085;ESCO.0722.00375.0085i_04406;7442;9607;2165
ESCO.0722.00375;ESCO.0722.00375.0294;ESCO.0722.00375.0294b_04854;1;219;218
ESCO.0722.00375;ESCO.0722.00375.0411;ESCO.0722.00375.0411b_04918;3;95;92
ESCO.0722.00375;ESCO.0722.00375.0011;ESCO.0722.00375.0011i_01370;63605;63829;224
ESCO.0722.00375;ESCO.0722.00375.0028;ESCO.0722.00375.0028b_02778;63;671;608
ESCO.0722.00375;ESCO.0722.00375.0048;ESCO.0722.00375.0048i_03450;27306;27620;314
ESCO.0722.00375;ESCO.0722.00375.0099;ESCO.0722.00375.0099i_04538;376;702;326
ESCO.0722.00375;ESCO.0722.00375.0262;ESCO.0722.00375.0262b_04826;59;238;179
ESCO.0722.00375;ESCO.0722.00375.0299;ESCO.0722.00375.0299b_04858;1;216;215
ESCO.0722.00375;ESCO.0722.00375.0004;ESCO.0722.00375.0004b_00475;83;292;209
ESCO.0722.00375;ESCO.0722.00375.0011;ESCO.0722.00375.0011i_01371;63842;65983;2141
ESCO.0722.00375;ESCO.0722.00375.0048;ESCO.0722.00375.0048i_03451;27617;29380;1763
ESCO.0722.00375;ESCO.0722.00375.0085;ESCO.0722.00375.0085i_04411;13858;13992;134
ESCO.0722.00375;ESCO.0722.00375.0099;ESCO.0722.00375.0099i_04539;699;962;263
ESCO.0722.00375;ESCO.0722.00375.0136;ESCO.0722.00375.0136b_04667;558;1787;1229
ESCO.0722.00375;ESCO.0722.00375.0263;ESCO.0722.00375.0263b_04827;3;239;236
ESCO.0722.00375;ESCO.0722.00375.0300;ESCO.0722.00375.0300b_04859;3;218;215
ESCO.0722.00375;ESCO.0722.00375.0011;ESCO.0722.00375.0011i_01372;65980;67134;1154
ESCO.0722.00375;ESCO.0722.00375.0048;ESCO.0722.00375.0048i_03452;29603;29767;164
ESCO.0722.00375;ESCO.0722.00375.0264;ESCO.0722.00375.0264b_04828;3;239;236
ESCO.0722.00375;ESCO.0722.00375.0301;ESCO.0722.00375.0301b_04860;3;215;212
ESCO.0722.00375;ESCO.0722.00375.0422;ESCO.0722.00375.0422b_04924;1;81;80
ESCO.0722.00375;ESCO.0722.00375.0011;ESCO.0722.00375.0011i_01373;67149;69281;2132
ESCO.0722.00375;ESCO.0722.00375.0032;ESCO.0722.00375.0032b_02845;33342;33785;443
ESCO.0722.00375;ESCO.0722.00375.0005;ESCO.0722.00375.0005i_00837;130689;131681;992
ESCO.0722.00375;ESCO.0722.00375.0041;ESCO.0722.00375.0041i_03205;40826;41968;1142
ESCO.0722.00375;ESCO.0722.00375.0076;ESCO.0722.00375.0076i_04261;7757;8419;662
ESCO.0722.00375;ESCO.0722.00375.0114;ESCO.0722.00375.0114b_04613;3597;3836;239
ESCO.0722.00375;ESCO.0722.00375.0277;ESCO.0722.00375.0277b_04837;1;228;227
ESCO.0722.00375;ESCO.0722.00375.0312;ESCO.0722.00375.0312b_04869;32;208;176
ESCO.0722.00375;ESCO.0722.00375.0005;ESCO.0722.00375.0005i_00806;104767;105000;233
ESCO.0722.00375;ESCO.0722.00375.0096;ESCO.0722.00375.0096b_04518;186;1448;1262
ESCO.0722.00375;ESCO.0722.00375.0107;ESCO.0722.00375.0107b_04582;4337;4531;194
ESCO.0722.00375;ESCO.0722.00375.0278;ESCO.0722.00375.0278b_04838;1;228;227
ESCO.0722.00375;ESCO.0722.00375.0313;ESCO.0722.00375.0313b_04870;144;209;65
ESCO.0722.00375;ESCO.0722.00375.0002;ESCO.0722.00375.0002b_00231;8029;11502;3473
ESCO.0722.00375;ESCO.0722.00375.0005;ESCO.0722.00375.0005i_00807;105019;106908;1889
ESCO.0722.00375;ESCO.0722.00375.0005;ESCO.0722.00375.0005i_00839;131957;132547;590
ESCO.0722.00375;ESCO.0722.00375.0116;ESCO.0722.00375.0116b_04615;3;125;122
ESCO.0722.00375;ESCO.0722.00375.0280;ESCO.0722.00375.0280b_04839;2;229;227
ESCO.0722.00375;ESCO.0722.00375.0315;ESCO.0722.00375.0315b_04871;13;207;194
ESCO.0722.00375;ESCO.0722.00375.0439;ESCO.0722.00375.0439b_04935;2;67;65
ESCO.0722.00375;ESCO.0722.00375.0052;ESCO.0722.00375.0052i_03635;33119;34300;1181
ESCO.0722.00375;ESCO.0722.00375.0085;ESCO.0722.00375.0085i_04403;3889;4827;938
ESCO.0722.00375;ESCO.0722.00375.0118;ESCO.0722.00375.0118b_04627;2309;3052;743
ESCO.0722.00375;ESCO.0722.00375.0221;ESCO.0722.00375.0221b_04787;77;349;272
ESCO.0722.00375;ESCO.0722.00375.0252;ESCO.0722.00375.0252b_04819;74;250;176
ESCO.0722.00375;ESCO.0722.00375.0290;ESCO.0722.00375.0290b_04851;143;220;77
ESCO.0722.00375;ESCO.0722.00375.0406;ESCO.0722.00375.0406b_04915;3;98;95
ESCO.0722.00375;ESCO.0722.00375.0011;ESCO.0722.00375.0011i_01364;56512;57687;1175
ESCO.0722.00375;ESCO.0722.00375.0048;ESCO.0722.00375.0048i_03444;24343;24933;590
ESCO.0722.00375;ESCO.0722.00375.0052;ESCO.0722.00375.0052i_03636;34405;34932;527
ESCO.0722.00375;ESCO.0722.00375.0072;ESCO.0722.00375.0072i_04180;16819;17265;446
ESCO.0722.00375;ESCO.0722.00375.0085;ESCO.0722.00375.0085i_04404;4964;5872;908
ESCO.0722.00375;ESCO.0722.00375.0090;ESCO.0722.00375.0090i_04468;6308;7846;1538
ESCO.0722.00375;ESCO.0722.00375.0222;ESCO.0722.00375.0222b_04788;2;343;341
ESCO.0722.00375;ESCO.0722.00375.0253;ESCO.0722.00375.0253b_04820;2;247;245
ESCO.0722.00375;ESCO.0722.00375.0011;ESCO.0722.00375.0011i_01365;57684;59282;1598
ESCO.0722.00375;ESCO.0722.00375.0048;ESCO.0722.00375.0048i_03445;25101;25298;197
ESCO.0722.00375;ESCO.0722.00375.0052;ESCO.0722.00375.0052i_03637;34952;35311;359
ESCO.0722.00375;ESCO.0722.00375.0077;ESCO.0722.00375.0077i_04277;7383;8057;674
ESCO.0722.00375;ESCO.0722.00375.0085;ESCO.0722.00375.0085i_04405;5912;7339;1427
ESCO.0722.00375;ESCO.0722.00375.0146;ESCO.0722.00375.0146b_04693;1338;1397;59
ESCO.0722.00375;ESCO.0722.00375.0223;ESCO.0722.00375.0223b_04789;3;149;146
ESCO.0722.00375;ESCO.0722.00375.0342;ESCO.0722.00375.0342b_04885;2;151;149
ESCO.0722.00375;ESCO.0722.00375.0409;ESCO.0722.00375.0409b_04917;3;95;92
ESCO.0722.00379;ESCO.0722.00379.0018;ESCO.0722.00379.0018i_02032;72570;73934;1364
ESCO.0722.00379;ESCO.0722.00379.0076;ESCO.0722.00379.0076i_04464;14832;15038;206
ESCO.0722.00379;ESCO.0722.00379.0106;ESCO.0722.00379.0106b_04752;4425;5081;656
ESCO.0722.00379;ESCO.0722.00379.0143;ESCO.0722.00379.0143b_04880;1;141;140
ESCO.0722.00379;ESCO.0722.00379.0161;ESCO.0722.00379.0161b_04912;3;125;122
ESCO.0722.00379;ESCO.0722.00379.0304;ESCO.0722.00379.0304b_05072;3;83;80
ESCO.0722.00379;ESCO.0722.00379.0021;ESCO.0722.00379.0021i_02239;43443;43595;152
ESCO.0722.00379;ESCO.0722.00379.0050;ESCO.0722.00379.0050i_03775;10240;10374;134
ESCO.0722.00379;ESCO.0722.00379.0099;ESCO.0722.00379.0099i_04703;3681;4511;830
ESCO.0722.00379;ESCO.0722.00379.0125;ESCO.0722.00379.0125b_04831;3558;3665;107
ESCO.0722.00379;ESCO.0722.00379.0284;ESCO.0722.00379.0284b_05055;3;224;221
ESCO.0722.00379;ESCO.0722.00379.0320;ESCO.0722.00379.0320b_05087;3;206;203
ESCO.0722.00379;ESCO.0722.00379.0025;ESCO.0722.00379.0025i_02688;95669;95809;140
ESCO.0722.00379;ESCO.0722.00379.0066;ESCO.0722.00379.0066b_04288;21520;22083;563
ESCO.0722.00379;ESCO.0722.00379.0126;ESCO.0722.00379.0126b_04832;123;1028;905
ESCO.0722.00379;ESCO.0722.00379.0168;ESCO.0722.00379.0168b_04928;562;831;269
ESCO.0722.00379;ESCO.0722.00379.0189;ESCO.0722.00379.0189b_04960;1;510;509
ESCO.0722.00379;ESCO.0722.00379.0285;ESCO.0722.00379.0285b_05056;2;226;224
ESCO.0722.00379;ESCO.0722.00379.0025;ESCO.0722.00379.0025i_02689;95907;96371;464
ESCO.0722.00379;ESCO.0722.00379.0078;ESCO.0722.00379.0078b_04481;168;1394;1226
ESCO.0722.00379;ESCO.0722.00379.0092;ESCO.0722.00379.0092i_04641;5307;5825;518
ESCO.0722.00379;ESCO.0722.00379.0126;ESCO.0722.00379.0126i_04833;1025;2263;1238
ESCO.0722.00379;ESCO.0722.00379.0322;ESCO.0722.00379.0322b_05089;1;201;200
ESCO.0722.00379;ESCO.0722.00379.0381;ESCO.0722.00379.0381b_05121;3;110;107
ESCO.0722.00379;ESCO.0722.00379.0090;ESCO.0722.00379.0090b_04628;8604;8888;284
ESCO.0722.00379;ESCO.0722.00379.0271;ESCO.0722.00379.0271b_05044;3;233;230
ESCO.0722.00379;ESCO.0722.00379.0307;ESCO.0722.00379.0307b_05076;2;157;155
ESCO.0722.00379;ESCO.0722.00379.0353;ESCO.0722.00379.0353b_05108;2;136;134
ESCO.0722.00379;ESCO.0722.00379.0043;ESCO.0722.00379.0043b_03509;14;178;164
ESCO.0722.00379;ESCO.0722.00379.0069;ESCO.0722.00379.0069i_04341;11603;12379;776
ESCO.0722.00379;ESCO.0722.00379.0072;ESCO.0722.00379.0072b_04405;17948;18283;335
ESCO.0722.00379;ESCO.0722.00379.0237;ESCO.0722.00379.0237b_05013;2;304;302
ESCO.0722.00379;ESCO.0722.00379.0272;ESCO.0722.00379.0272b_05045;2;232;230
ESCO.0722.00379;ESCO.0722.00379.0308;ESCO.0722.00379.0308b_05077;3;212;209
ESCO.0722.00379;ESCO.0722.00379.0355;ESCO.0722.00379.0355b_05109;3;128;125
ESCO.0722.00379;ESCO.0722.00379.0069;ESCO.0722.00379.0069i_04342;12376;13047;671
ESCO.0722.00379;ESCO.0722.00379.0238;ESCO.0722.00379.0238b_05014;3;305;302
ESCO.0722.00379;ESCO.0722.00379.0273;ESCO.0722.00379.0273b_05046;3;230;227
ESCO.0722.00379;ESCO.0722.00379.0309;ESCO.0722.00379.0309b_05078;40;210;170
ESCO.0722.00379;ESCO.0722.00379.0025;ESCO.0722.00379.0025i_02600;7803;8051;248
ESCO.0722.00379;ESCO.0722.00379.0392;ESCO.0722.00379.0392b_05128;3;86;83
ESCO.0722.00379;ESCO.0722.00379.0005;ESCO.0722.00379.0005b_00745;39493;40056;563
ESCO.0722.00379;ESCO.0722.00379.0021;ESCO.0722.00379.0021i_02249;49275;49379;104
ESCO.0722.00379;ESCO.0722.00379.0096;ESCO.0722.00379.0096b_04681;6757;7242;485
ESCO.0722.00379;ESCO.0722.00379.0255;ESCO.0722.00379.0255b_05033;1;255;254
ESCO.0722.00379;ESCO.0722.00379.0294;ESCO.0722.00379.0294b_05065;1;222;221
ESCO.0722.00379;ESCO.0722.00379.0018;ESCO.0722.00379.0018i_02030;71225;71545;320
ESCO.0722.00379;ESCO.0722.00379.0034;ESCO.0722.00379.0034b_03150;67969;68445;476
ESCO.0722.00379;ESCO.0722.00379.0302;ESCO.0722.00379.0302b_05070;3;218;215
ESCO.0722.00379;ESCO.0722.00379.0025;ESCO.0722.00379.0025i_02629;36656;40633;3977
ESCO.0722.00379;ESCO.0722.00379.0063;ESCO.0722.00379.0063i_04197;1631;2032;401
ESCO.0722.00379;ESCO.0722.00379.0092;ESCO.0722.00379.0092i_04645;7012;7374;362
ESCO.0722.00379;ESCO.0722.00379.0092;ESCO.0722.00379.0092b_04646;7399;7992;593
ESCO.0722.00379;ESCO.0722.00379.0113;ESCO.0722.00379.0113b_04774;483;734;251
ESCO.0722.00379;ESCO.0722.00379.0221;ESCO.0722.00379.0221b_04998;2;352;350
ESCO.0722.00379;ESCO.0722.00379.0291;ESCO.0722.00379.0291b_05062;86;223;137
ESCO.0722.00379;ESCO.0722.00379.0328;ESCO.0722.00379.0328b_05094;2;184;182
ESCO.0722.00379;ESCO.0722.00379.0194;ESCO.0722.00379.0194b_04967;2;493;491
ESCO.0722.00379;ESCO.0722.00379.0018;ESCO.0722.00379.0018i_02031;71484;72461;977
ESCO.0722.00379;ESCO.0722.00379.0030;ESCO.0722.00379.0030b_02959;29;889;860
ESCO.0722.00379;ESCO.0722.00379.0054;ESCO.0722.00379.0054b_03919;33;479;446
ESCO.0722.00379;ESCO.0722.00379.0076;ESCO.0722.00379.0076i_04463;11820;14441;2621
ESCO.0722.00379;ESCO.0722.00379.0303;ESCO.0722.00379.0303b_05071;1;216;215
ESCO.0722.00379;ESCO.0722.00379.0412;ESCO.0722.00379.0412b_05135;2;64;62
ESCO.0722.00379;ESCO.0722.00379.0069;ESCO.0722.00379.0069b_04345;18061;19344;1283
ESCO.0722.00379;ESCO.0722.00379.0276;ESCO.0722.00379.0276b_05049;2;229;227
ESCO.0722.00379;ESCO.0722.00379.0312;ESCO.0722.00379.0312b_05081;1;210;209
ESCO.0722.00379;ESCO.0722.00379.0366;ESCO.0722.00379.0366b_05113;1;117;116
ESCO.0722.00379;ESCO.0722.00379.0009;ESCO.0722.00379.0009b_01146;14;304;290
ESCO.0722.00379;ESCO.0722.00379.0025;ESCO.0722.00379.0025i_02618;20804;21136;332
ESCO.0722.00379;ESCO.0722.00379.0094;ESCO.0722.00379.0094i_04666;5968;6336;368
ESCO.0722.00379;ESCO.0722.00379.0278;ESCO.0722.00379.0278b_05051;2;226;224
ESCO.0722.00379;ESCO.0722.00379.0315;ESCO.0722.00379.0315b_05083;1;156;155
ESCO.0722.00379;ESCO.0722.00379.0368;ESCO.0722.00379.0368b_05115;1;117;116
ESCO.0722.00379;ESCO.0722.00379.0069;ESCO.0722.00379.0069i_04343;13051;14142;1091
ESCO.0722.00379;ESCO.0722.00379.0310;ESCO.0722.00379.0310b_05079;115;210;95
ESCO.0722.00379;ESCO.0722.00379.0039;ESCO.0722.00379.0039b_03320;65;547;482
ESCO.0722.00379;ESCO.0722.00379.0069;ESCO.0722.00379.0069i_04344;14146;17667;3521
ESCO.0722.00379;ESCO.0722.00379.0021;ESCO.0722.00379.0021i_02242;46111;46662;551
ESCO.0722.00379;ESCO.0722.00379.0025;ESCO.0722.00379.0025i_02626;35228;35551;323
ESCO.0722.00379;ESCO.0722.00379.0126;ESCO.0722.00379.0126i_04834;2263;2847;584
ESCO.0722.00379;ESCO.0722.00379.0154;ESCO.0722.00379.0154b_04898;2;199;197
ESCO.0722.00379;ESCO.0722.00379.0287;ESCO.0722.00379.0287b_05058;2;223;221
ESCO.0722.00379;ESCO.0722.00379.0071;ESCO.0722.00379.0071b_04387;17744;18397;653
ESCO.0722.00379;ESCO.0722.00379.0075;ESCO.0722.00379.0075b_04451;15798;16373;575
ESCO.0722.00379;ESCO.0722.00379.0088;ESCO.0722.00379.0088b_04611;8410;9330;920
ESCO.0722.00379;ESCO.0722.00379.0092;ESCO.0722.00379.0092i_04643;6096;6293;197
ESCO.0722.00379;ESCO.0722.00379.0096;ESCO.0722.00379.0096b_04675;3;230;227
ESCO.0722.00379;ESCO.0722.00379.0126;ESCO.0722.00379.0126b_04835;3358;3621;263
ESCO.0722.00379;ESCO.0722.00379.0249;ESCO.0722.00379.0249b_05027;39;266;227
ESCO.0722.00379;ESCO.0722.00379.0063;ESCO.0722.00379.0063i_04196;1393;1671;278
ESCO.0722.00379;ESCO.0722.00379.0092;ESCO.0722.00379.0092i_04644;6776;7015;239
ESCO.0722.00379;ESCO.0722.00379.0112;ESCO.0722.00379.0112i_04772;3680;3940;260
ESCO.0722.00379;ESCO.0722.00379.0119;ESCO.0722.00379.0119b_04804;23;739;716
ESCO.0722.00379;ESCO.0722.00379.0018;ESCO.0722.00379.0018i_02029;71033;71188;155
ESCO.0722.00379;ESCO.0722.00379.0032;ESCO.0722.00379.0032b_03085;1;807;806
ESCO.0722.00379;ESCO.0722.00379.0076;ESCO.0722.00379.0076i_04461;11027;11302;275
ESCO.0722.00379;ESCO.0722.00379.0129;ESCO.0722.00379.0129b_04845;2601;2864;263
ESCO.0722.00379;ESCO.0722.00379.0300;ESCO.0722.00379.0300b_05069;3;218;215
ESCO.0722.00379;ESCO.0722.00379.0404;ESCO.0722.00379.0404b_05133;3;71;68
ESCO.0722.00379;ESCO.0722.00379.0043;ESCO.0722.00379.0043i_03537;28614;29075;461
ESCO.0722.00379;ESCO.0722.00379.0076;ESCO.0722.00379.0076i_04465;15346;15783;437
ESCO.0722.00379;ESCO.0722.00379.0098;ESCO.0722.00379.0098b_04689;2;124;122
ESCO.0722.00379;ESCO.0722.00379.0201;ESCO.0722.00379.0201b_04977;2;460;458
ESCO.0722.00379;ESCO.0722.00379.0267;ESCO.0722.00379.0267b_05041;78;239;161
ESCO.0722.00379;ESCO.0722.00379.0304;ESCO.0722.00379.0304b_05073;83;217;134
ESCO.0722.00379;ESCO.0722.00379.0001;ESCO.0722.00379.0001b_00274;289587;289841;254
ESCO.0722.00379;ESCO.0722.00379.0017;ESCO.0722.00379.0017b_01842;66;425;359
ESCO.0722.00379;ESCO.0722.00379.0076;ESCO.0722.00379.0076b_04466;15729;15986;257
ESCO.0722.00379;ESCO.0722.00379.0087;ESCO.0722.00379.0087b_04594;412;1545;1133
ESCO.0722.00379;ESCO.0722.00379.0098;ESCO.0722.00379.0098i_04690;135;1340;1205
ESCO.0722.00379;ESCO.0722.00379.0115;ESCO.0722.00379.0115i_04786;2461;3456;995
ESCO.0722.00379;ESCO.0722.00379.0305;ESCO.0722.00379.0305b_05074;87;215;128
ESCO.0722.00379;ESCO.0722.00379.0350;ESCO.0722.00379.0350b_05106;3;140;137
ESCO.0722.00379;ESCO.0722.00379.0077;ESCO.0722.00379.0077b_04467;54;266;212
ESCO.0722.00379;ESCO.0722.00379.0087;ESCO.0722.00379.0087i_04595;1579;2091;512
ESCO.0722.00379;ESCO.0722.00379.0098;ESCO.0722.00379.0098i_04691;1496;1699;203
ESCO.0722.00379;ESCO.0722.00379.0115;ESCO.0722.00379.0115b_04787;3856;4446;590
ESCO.0722.00379;ESCO.0722.00379.0236;ESCO.0722.00379.0236b_05011;3;92;89
ESCO.0722.00379;ESCO.0722.00379.0306;ESCO.0722.00379.0306b_05075;1;213;212
ESCO.0722.00379;ESCO.0722.00379.0025;ESCO.0722.00379.0025i_02620;23972;25924;1952
ESCO.0722.00379;ESCO.0722.00379.0061;ESCO.0722.00379.0061b_04124;98;844;746
ESCO.0722.00379;ESCO.0722.00379.0092;ESCO.0722.00379.0092b_04636;3;353;350
ESCO.0722.00379;ESCO.0722.00379.0316;ESCO.0722.00379.0316b_05084;1;207;206
ESCO.0722.00379;ESCO.0722.00379.0369;ESCO.0722.00379.0369b_05116;3;113;110
ESCO.0722.00379;ESCO.0722.00379.0025;ESCO.0722.00379.0025i_02621;25929;28559;2630
ESCO.0722.00379;ESCO.0722.00379.0025;ESCO.0722.00379.0025i_02685;93691;94281;590
ESCO.0722.00379;ESCO.0722.00379.0050;ESCO.0722.00379.0050b_03805;39572;39982;410
ESCO.0722.00379;ESCO.0722.00379.0092;ESCO.0722.00379.0092i_04637;356;1948;1592
ESCO.0722.00379;ESCO.0722.00379.0125;ESCO.0722.00379.0125i_04829;2638;2895;257
ESCO.0722.00379;ESCO.0722.00379.0134;ESCO.0722.00379.0134b_04861;1866;2306;440
ESCO.0722.00379;ESCO.0722.00379.0281;ESCO.0722.00379.0281b_05053;1;225;224
ESCO.0722.00379;ESCO.0722.00379.0318;ESCO.0722.00379.0318b_05085;3;206;203
ESCO.0722.00379;ESCO.0722.00379.0371;ESCO.0722.00379.0371b_05117;2;109;107
ESCO.0722.00379;ESCO.0722.00379.0028;ESCO.0722.00379.0028b_02878;95260;95628;368
ESCO.0722.00379;ESCO.0722.00379.0092;ESCO.0722.00379.0092i_04638;1987;2685;698
ESCO.0722.00379;ESCO.0722.00379.0099;ESCO.0722.00379.0099i_04702;2665;3681;1016
ESCO.0722.00379;ESCO.0722.00379.0118;ESCO.0722.00379.0118b_04798;55;972;917
ESCO.0722.00379;ESCO.0722.00379.0125;ESCO.0722.00379.0125i_04830;3084;3512;428
ESCO.0722.00379;ESCO.0722.00379.0283;ESCO.0722.00379.0283b_05054;1;225;224
ESCO.0722.00379;ESCO.0722.00379.0319;ESCO.0722.00379.0319b_05086;1;207;206
ESCO.0722.00379;ESCO.0722.00379.0021;ESCO.0722.00379.0021i_02250;49448;51625;2177
ESCO.0722.00379;ESCO.0722.00379.0141;ESCO.0722.00379.0141b_04874;2;214;212
ESCO.0722.00379;ESCO.0722.00379.0297;ESCO.0722.00379.0297b_05066;2;148;146
ESCO.0722.00379;ESCO.0722.00379.0005;ESCO.0722.00379.0005i_00715;4749;5195;446
ESCO.0722.00379;ESCO.0722.00379.0021;ESCO.0722.00379.0021i_02251;51784;52572;788
ESCO.0722.00379;ESCO.0722.00379.0031;ESCO.0722.00379.0031i_03083;61305;62663;1358
ESCO.0722.00379;ESCO.0722.00379.0055;ESCO.0722.00379.0055b_03979;33247;33927;680
ESCO.0722.00379;ESCO.0722.00379.0069;ESCO.0722.00379.0069i_04331;620;799;179
ESCO.0722.00379;ESCO.0722.00379.0076;ESCO.0722.00379.0076i_04459;10001;10270;269
ESCO.0722.00379;ESCO.0722.00379.0083;ESCO.0722.00379.0083i_04555;10138;10809;671
ESCO.0722.00379;ESCO.0722.00379.0259;ESCO.0722.00379.0259b_05035;3;251;248
ESCO.0722.00379;ESCO.0722.00379.0298;ESCO.0722.00379.0298b_05067;3;218;215
ESCO.0722.00379;ESCO.0722.00379.0395;ESCO.0722.00379.0395b_05131;2;85;83
ESCO.0722.00379;ESCO.0722.00379.0021;ESCO.0722.00379.0021i_02252;52569;54212;1643
ESCO.0722.00379;ESCO.0722.00379.0031;ESCO.0722.00379.0031b_03084;62668;62937;269
ESCO.0722.00379;ESCO.0722.00379.0042;ESCO.0722.00379.0042i_03500;38462;39067;605
ESCO.0722.00379;ESCO.0722.00379.0076;ESCO.0722.00379.0076i_04460;10274;10804;530
ESCO.0722.00379;ESCO.0722.00379.0083;ESCO.0722.00379.0083b_04556;10778;11434;656
ESCO.0722.00379;ESCO.0722.00379.0299;ESCO.0722.00379.0299b_05068;3;218;215
ESCO.0722.00383;ESCO.0722.00383.0132;ESCO.0722.00383.0132b_04545;1507;2136;629
ESCO.0722.00383;ESCO.0722.00383.0274;ESCO.0722.00383.0274b_04737;3;77;74
ESCO.0722.00383;ESCO.0722.00383.0371;ESCO.0722.00383.0371b_04801;1;75;74
ESCO.0722.00383;ESCO.0722.00383.0056;ESCO.0722.00383.0056b_03600;37442;37936;494
ESCO.0722.00383;ESCO.0722.00383.0057;ESCO.0722.00383.0057i_03632;32654;33052;398
ESCO.0722.00383;ESCO.0722.00383.0090;ESCO.0722.00383.0090i_04304;5165;5689;524
ESCO.0722.00383;ESCO.0722.00383.0138;ESCO.0722.00383.0138b_04560;776;1924;1148
ESCO.0722.00383;ESCO.0722.00383.0169;ESCO.0722.00383.0169b_04624;1;870;869
ESCO.0722.00383;ESCO.0722.00383.0193;ESCO.0722.00383.0193b_04656;3;173;170
ESCO.0722.00383;ESCO.0722.00383.0222;ESCO.0722.00383.0222b_04688;1;354;353
ESCO.0722.00383;ESCO.0722.00383.0292;ESCO.0722.00383.0292b_04752;3;212;209
ESCO.0722.00383;ESCO.0722.00383.0078;ESCO.0722.00383.0078i_04145;5891;6634;743
ESCO.0722.00383;ESCO.0722.00383.0080;ESCO.0722.00383.0080b_04177;14207;14269;62
ESCO.0722.00383;ESCO.0722.00383.0096;ESCO.0722.00383.0096i_04369;3413;3988;575
ESCO.0722.00383;ESCO.0722.00383.0193;ESCO.0722.00383.0193b_04657;420;500;80
ESCO.0722.00383;ESCO.0722.00383.0020;ESCO.0722.00383.0020i_02130;111575;111979;404
ESCO.0722.00383;ESCO.0722.00383.0078;ESCO.0722.00383.0078i_04146;6647;7210;563
ESCO.0722.00383;ESCO.0722.00383.0090;ESCO.0722.00383.0090i_04306;6611;7108;497
ESCO.0722.00383;ESCO.0722.00383.0096;ESCO.0722.00383.0096i_04370;4004;4192;188
ESCO.0722.00383;ESCO.0722.00383.0139;ESCO.0722.00383.0139b_04562;1300;1923;623
ESCO.0722.00383;ESCO.0722.00383.0255;ESCO.0722.00383.0255b_04722;3;209;206
ESCO.0722.00383;ESCO.0722.00383.0295;ESCO.0722.00383.0295b_04754;90;209;119
ESCO.0722.00383;ESCO.0722.00383.0030;ESCO.0722.00383.0030b_02661;64441;64962;521
ESCO.0722.00383;ESCO.0722.00383.0011;ESCO.0722.00383.0011i_01158;29089;30204;1115
ESCO.0722.00383;ESCO.0722.00383.0060;ESCO.0722.00383.0060i_03718;8520;9191;671
ESCO.0722.00383;ESCO.0722.00383.0108;ESCO.0722.00383.0108b_04454;2;1807;1805
ESCO.0722.00383;ESCO.0722.00383.0213;ESCO.0722.00383.0213b_04678;2;382;380
ESCO.0722.00383;ESCO.0722.00383.0018;ESCO.0722.00383.0018b_01927;86194;86889;695
ESCO.0722.00383;ESCO.0722.00383.0060;ESCO.0722.00383.0060i_03719;9328;9555;227
ESCO.0722.00383;ESCO.0722.00383.0148;ESCO.0722.00383.0148b_04583;630;1343;713
ESCO.0722.00383;ESCO.0722.00383.0164;ESCO.0722.00383.0164b_04615;109;786;677
ESCO.0722.00383;ESCO.0722.00383.0183;ESCO.0722.00383.0183b_04647;1;369;368
ESCO.0722.00383;ESCO.0722.00383.0241;ESCO.0722.00383.0241b_04711;3;278;275
ESCO.0722.00383;ESCO.0722.00383.0032;ESCO.0722.00383.0032i_02777;60357;61577;1220
ESCO.0722.00383;ESCO.0722.00383.0093;ESCO.0722.00383.0093b_04345;8385;9287;902
ESCO.0722.00383;ESCO.0722.00383.0110;ESCO.0722.00383.0110b_04473;4759;4893;134
ESCO.0722.00383;ESCO.0722.00383.0120;ESCO.0722.00383.0120i_04505;1129;1428;299
ESCO.0722.00383;ESCO.0722.00383.0200;ESCO.0722.00383.0200b_04665;1;435;434
ESCO.0722.00383;ESCO.0722.00383.0263;ESCO.0722.00383.0263b_04729;2;94;92
ESCO.0722.00383;ESCO.0722.00383.0032;ESCO.0722.00383.0032i_02778;61574;62428;854
ESCO.0722.00383;ESCO.0722.00383.0063;ESCO.0722.00383.0063b_03802;52;279;227
ESCO.0722.00383;ESCO.0722.00383.0066;ESCO.0722.00383.0066b_03898;3;836;833
ESCO.0722.00383;ESCO.0722.00383.0072;ESCO.0722.00383.0072i_04058;11595;12515;920
ESCO.0722.00383;ESCO.0722.00383.0106;ESCO.0722.00383.0106b_04442;21;1271;1250
ESCO.0722.00383;ESCO.0722.00383.0201;ESCO.0722.00383.0201b_04666;1;162;161
ESCO.0722.00383;ESCO.0722.00383.0265;ESCO.0722.00383.0265b_04730;3;242;239
ESCO.0722.00383;ESCO.0722.00383.0304;ESCO.0722.00383.0304b_04762;2;187;185
ESCO.0722.00383;ESCO.0722.00383.0072;ESCO.0722.00383.0072i_04063;16728;18878;2150
ESCO.0722.00383;ESCO.0722.00383.0159;ESCO.0722.00383.0159b_04607;305;529;224
ESCO.0722.00383;ESCO.0722.00383.0206;ESCO.0722.00383.0206b_04671;2;421;419
ESCO.0722.00383;ESCO.0722.00383.0367;ESCO.0722.00383.0367b_04799;1;81;80
ESCO.0722.00383;ESCO.0722.00383.0017;ESCO.0722.00383.0017b_01814;264;848;584
ESCO.0722.00383;ESCO.0722.00383.0072;ESCO.0722.00383.0072i_04054;7807;9021;1214
ESCO.0722.00383;ESCO.0722.00383.0090;ESCO.0722.00383.0090i_04310;8558;9631;1073
ESCO.0722.00383;ESCO.0722.00383.0093;ESCO.0722.00383.0093i_04342;7523;7801;278
ESCO.0722.00383;ESCO.0722.00383.0258;ESCO.0722.00383.0258b_04726;3;251;248
ESCO.0722.00383;ESCO.0722.00383.0008;ESCO.0722.00383.0008i_00695;59530;61149;1619
ESCO.0722.00383;ESCO.0722.00383.0011;ESCO.0722.00383.0011i_01175;41606;42202;596
ESCO.0722.00383;ESCO.0722.00383.0021;ESCO.0722.00383.0021i_02199;68552;69163;611
ESCO.0722.00383;ESCO.0722.00383.0072;ESCO.0722.00383.0072i_04055;9024;9491;467
ESCO.0722.00383;ESCO.0722.00383.0093;ESCO.0722.00383.0093i_04343;7919;8062;143
ESCO.0722.00383;ESCO.0722.00383.0100;ESCO.0722.00383.0100i_04407;3244;4119;875
ESCO.0722.00383;ESCO.0722.00383.0175;ESCO.0722.00383.0175b_04631;84;323;239
ESCO.0722.00383;ESCO.0722.00383.0261;ESCO.0722.00383.0261b_04727;3;242;239
ESCO.0722.00383;ESCO.0722.00383.0301;ESCO.0722.00383.0301b_04759;1;201;200
ESCO.0722.00383;ESCO.0722.00383.0008;ESCO.0722.00383.0008i_00696;61153;62643;1490
ESCO.0722.00383;ESCO.0722.00383.0011;ESCO.0722.00383.0011i_01176;42223;43899;1676
ESCO.0722.00383;ESCO.0722.00383.0072;ESCO.0722.00383.0072i_04056;9493;10461;968
ESCO.0722.00383;ESCO.0722.00383.0074;ESCO.0722.00383.0074b_04088;3;185;182
ESCO.0722.00383;ESCO.0722.00383.0093;ESCO.0722.00383.0093i_04344;8179;8379;200
ESCO.0722.00383;ESCO.0722.00383.0120;ESCO.0722.00383.0120b_04504;876;1139;263
ESCO.0722.00383;ESCO.0722.00383.0175;ESCO.0722.00383.0175b_04632;296;742;446
ESCO.0722.00383;ESCO.0722.00383.0262;ESCO.0722.00383.0262b_04728;2;244;242
ESCO.0722.00383;ESCO.0722.00383.0024;ESCO.0722.00383.0024b_02400;91572;91682;110
ESCO.0722.00383;ESCO.0722.00383.0072;ESCO.0722.00383.0072i_04064;18897;19244;347
ESCO.0722.00383;ESCO.0722.00383.0272;ESCO.0722.00383.0272b_04736;1;207;206
ESCO.0722.00383;ESCO.0722.00383.0011;ESCO.0722.00383.0011i_01162;33900;34316;416
ESCO.0722.00383;ESCO.0722.00383.0090;ESCO.0722.00383.0090b_04298;35;694;659
ESCO.0722.00383;ESCO.0722.00383.0116;ESCO.0722.00383.0116b_04490;254;3820;3566
ESCO.0722.00383;ESCO.0722.00383.0185;ESCO.0722.00383.0185b_04650;27;578;551
ESCO.0722.00383;ESCO.0722.00383.0217;ESCO.0722.00383.0217b_04682;266;376;110
ESCO.0722.00383;ESCO.0722.00383.0011;ESCO.0722.00383.0011i_01163;34309;34572;263
ESCO.0722.00383;ESCO.0722.00383.0080;ESCO.0722.00383.0080b_04171;310;555;245
ESCO.0722.00383;ESCO.0722.00383.0108;ESCO.0722.00383.0108b_04459;4983;5150;167
ESCO.0722.00383;ESCO.0722.00383.0117;ESCO.0722.00383.0117b_04491;529;678;149
ESCO.0722.00383;ESCO.0722.00383.0218;ESCO.0722.00383.0218b_04683;3;371;368
ESCO.0722.00383;ESCO.0722.00383.0247;ESCO.0722.00383.0247b_04715;114;269;155
ESCO.0722.00383;ESCO.0722.00383.0286;ESCO.0722.00383.0286b_04747;3;218;215
ESCO.0722.00383;ESCO.0722.00383.0006;ESCO.0722.00383.0006i_00428;55550;58801;3251
ESCO.0722.00383;ESCO.0722.00383.0011;ESCO.0722.00383.0011i_01164;34575;35468;893
ESCO.0722.00383;ESCO.0722.00383.0056;ESCO.0722.00383.0056b_03564;118;417;299
ESCO.0722.00383;ESCO.0722.00383.0096;ESCO.0722.00383.0096b_04364;2;76;74
ESCO.0722.00383;ESCO.0722.00383.0098;ESCO.0722.00383.0098b_04396;7740;7964;224
ESCO.0722.00383;ESCO.0722.00383.0187;ESCO.0722.00383.0187b_04652;422;568;146
ESCO.0722.00383;ESCO.0722.00383.0288;ESCO.0722.00383.0288b_04748;1;216;215
ESCO.0722.00383;ESCO.0722.00383.0044;ESCO.0722.00383.0044i_03208;40270;41019;749
ESCO.0722.00383;ESCO.0722.00383.0281;ESCO.0722.00383.0281b_04744;2;223;221
ESCO.0722.00383;ESCO.0722.00383.0322;ESCO.0722.00383.0322b_04776;2;124;122
ESCO.0722.00383;ESCO.0722.00383.0044;ESCO.0722.00383.0044i_03209;41024;41185;161
ESCO.0722.00383;ESCO.0722.00383.0243;ESCO.0722.00383.0243b_04713;3;272;269
ESCO.0722.00383;ESCO.0722.00383.0020;ESCO.0722.00383.0020b_02131;111961;112368;407
ESCO.0722.00383;ESCO.0722.00383.0090;ESCO.0722.00383.0090i_04307;7169;7540;371
ESCO.0722.00383;ESCO.0722.00383.0096;ESCO.0722.00383.0096i_04371;4189;4284;95
ESCO.0722.00383;ESCO.0722.00383.0127;ESCO.0722.00383.0127i_04531;1056;1619;563
ESCO.0722.00383;ESCO.0722.00383.0140;ESCO.0722.00383.0140b_04563;2;1921;1919
ESCO.0722.00383;ESCO.0722.00383.0195;ESCO.0722.00383.0195b_04659;3;473;470
ESCO.0722.00383;ESCO.0722.00383.0256;ESCO.0722.00383.0256b_04723;153;257;104
ESCO.0722.00383;ESCO.0722.00383.0296;ESCO.0722.00383.0296b_04755;2;208;206
ESCO.0722.00383;ESCO.0722.00383.0060;ESCO.0722.00383.0060i_03732;15956;16303;347
ESCO.0722.00383;ESCO.0722.00383.0073;ESCO.0722.00383.0073i_04084;15607;16704;1097
ESCO.0722.00383;ESCO.0722.00383.0090;ESCO.0722.00383.0090i_04308;7950;8327;377
ESCO.0722.00383;ESCO.0722.00383.0096;ESCO.0722.00383.0096i_04372;4288;5184;896
ESCO.0722.00383;ESCO.0722.00383.0099;ESCO.0722.00383.0099b_04404;7163;7738;575
ESCO.0722.00383;ESCO.0722.00383.0172;ESCO.0722.00383.0172b_04628;369;815;446
ESCO.0722.00383;ESCO.0722.00383.0298;ESCO.0722.00383.0298b_04756;48;206;158
ESCO.0722.00383;ESCO.0722.00383.0058;ESCO.0722.00383.0058i_03669;30263;30415;152
ESCO.0722.00383;ESCO.0722.00383.0072;ESCO.0722.00383.0072i_04053;6101;7504;1403
ESCO.0722.00383;ESCO.0722.00383.0090;ESCO.0722.00383.0090i_04309;8377;8502;125
ESCO.0722.00383;ESCO.0722.00383.0093;ESCO.0722.00383.0093i_04341;7327;7503;176
ESCO.0722.00383;ESCO.0722.00383.0100;ESCO.0722.00383.0100b_04405;2;163;161
ESCO.0722.00383;ESCO.0722.00383.0173;ESCO.0722.00383.0173b_04629;3;815;812
ESCO.0722.00383;ESCO.0722.00383.0196;ESCO.0722.00383.0196b_04661;261;449;188
ESCO.0722.00383;ESCO.0722.00383.0225;ESCO.0722.00383.0225b_04693;259;336;77
ESCO.0722.00383;ESCO.0722.00383.0257;ESCO.0722.00383.0257b_04725;170;253;83
ESCO.0722.00383;ESCO.0722.00383.0299;ESCO.0722.00383.0299b_04757;1;204;203
ESCO.0722.00383;ESCO.0722.00383.0033;ESCO.0722.00383.0033b_02782;2;100;98
ESCO.0722.00383;ESCO.0722.00383.0072;ESCO.0722.00383.0072i_04062;15515;16675;1160
ESCO.0722.00383;ESCO.0722.00383.0107;ESCO.0722.00383.0107b_04446;1;456;455
ESCO.0722.00383;ESCO.0722.00383.0178;ESCO.0722.00383.0178b_04638;500;649;149
ESCO.0722.00383;ESCO.0722.00383.0311;ESCO.0722.00383.0311b_04766;2;157;155
ESCO.0722.00383;ESCO.0722.00383.0060;ESCO.0722.00383.0060i_03714;5493;5789;296
ESCO.0722.00383;ESCO.0722.00383.0089;ESCO.0722.00383.0089b_04290;78;1097;1019
ESCO.0722.00383;ESCO.0722.00383.0101;ESCO.0722.00383.0101b_04418;6899;7258;359
ESCO.0722.00383;ESCO.0722.00383.0121;ESCO.0722.00383.0121b_04514;2925;3365;440
ESCO.0722.00383;ESCO.0722.00383.0133;ESCO.0722.00383.0133b_04546;3;917;914
ESCO.0722.00383;ESCO.0722.00383.0274;ESCO.0722.00383.0274b_04738;74;229;155
ESCO.0722.00383;ESCO.0722.00383.0315;ESCO.0722.00383.0315b_04770;76;135;59
ESCO.0722.00383;ESCO.0722.00383.0076;ESCO.0722.00383.0076b_04131;3;539;536
ESCO.0722.00383;ESCO.0722.00383.0089;ESCO.0722.00383.0089i_04291;1257;3539;2282
ESCO.0722.00383;ESCO.0722.00383.0094;ESCO.0722.00383.0094b_04355;8114;9067;953
ESCO.0722.00383;ESCO.0722.00383.0161;ESCO.0722.00383.0161b_04611;1;840;839
ESCO.0722.00383;ESCO.0722.00383.0238;ESCO.0722.00383.0238b_04707;2;292;290
ESCO.0722.00383;ESCO.0722.00383.0276;ESCO.0722.00383.0276b_04739;2;226;224
ESCO.0722.00383;ESCO.0722.00383.0317;ESCO.0722.00383.0317b_04771;2;130;128
ESCO.0722.00383;ESCO.0722.00383.0051;ESCO.0722.00383.0051i_03428;852;1097;245
ESCO.0722.00383;ESCO.0722.00383.0182;ESCO.0722.00383.0182b_04644;3;134;131
ESCO.0722.00383;ESCO.0722.00383.0277;ESCO.0722.00383.0277b_04740;3;227;224
ESCO.0722.00383;ESCO.0722.00383.0006;ESCO.0722.00383.0006b_00429;59434;59646;212
ESCO.0722.00383;ESCO.0722.00383.0090;ESCO.0722.00383.0090i_04301;3288;3614;326
ESCO.0722.00383;ESCO.0722.00383.0096;ESCO.0722.00383.0096i_04365;18;950;932
ESCO.0722.00383;ESCO.0722.00383.0117;ESCO.0722.00383.0117i_04493;2572;2829;257
ESCO.0722.00383;ESCO.0722.00383.0220;ESCO.0722.00383.0220b_04685;288;371;83
ESCO.0722.00383;ESCO.0722.00383.0289;ESCO.0722.00383.0289b_04749;1;216;215
ESCO.0722.00383;ESCO.0722.00383.0007;ESCO.0722.00383.0007b_00430;3;338;335
ESCO.0722.00383;ESCO.0722.00383.0040;ESCO.0722.00383.0040b_03086;41028;41252;224
ESCO.0722.00383;ESCO.0722.00383.0080;ESCO.0722.00383.0080i_04174;12210;12425;215
ESCO.0722.00383;ESCO.0722.00383.0090;ESCO.0722.00383.0090i_04302;3729;4265;536
ESCO.0722.00383;ESCO.0722.00383.0096;ESCO.0722.00383.0096i_04366;1214;2416;1202
ESCO.0722.00383;ESCO.0722.00383.0117;ESCO.0722.00383.0117i_04494;3003;3218;215
ESCO.0722.00383;ESCO.0722.00383.0189;ESCO.0722.00383.0189b_04654;3;548;545
ESCO.0722.00383;ESCO.0722.00383.0290;ESCO.0722.00383.0290b_04750;3;143;140
ESCO.0722.00383;ESCO.0722.00383.0019;ESCO.0722.00383.0019b_02031;114339;115622;1283
ESCO.0722.00383;ESCO.0722.00383.0039;ESCO.0722.00383.0039b_03055;57787;57864;77
ESCO.0722.00383;ESCO.0722.00383.0066;ESCO.0722.00383.0066b_03919;24647;26551;1904
ESCO.0722.00383;ESCO.0722.00383.0046;ESCO.0722.00383.0046b_03259;3;701;698
ESCO.0722.00383;ESCO.0722.00383.0072;ESCO.0722.00383.0072i_04059;12508;13047;539
ESCO.0722.00383;ESCO.0722.00383.0130;ESCO.0722.00383.0130b_04539;1;2511;2510
ESCO.0722.00383;ESCO.0722.00383.0177;ESCO.0722.00383.0177b_04635;1;663;662
ESCO.0722.00383;ESCO.0722.00383.0202;ESCO.0722.00383.0202b_04667;1;432;431
ESCO.0722.00383;ESCO.0722.00383.0230;ESCO.0722.00383.0230b_04699;2;328;326
ESCO.0722.00383;ESCO.0722.00383.0307;ESCO.0722.00383.0307b_04763;1;174;173
ESCO.0722.00383;ESCO.0722.00383.0050;ESCO.0722.00383.0050b_03420;17;280;263
ESCO.0722.00383;ESCO.0722.00383.0072;ESCO.0722.00383.0072i_04060;13085;14167;1082
ESCO.0722.00383;ESCO.0722.00383.0106;ESCO.0722.00383.0106i_04444;4290;4661;371
ESCO.0722.00383;ESCO.0722.00383.0120;ESCO.0722.00383.0120b_04508;3396;3500;104
ESCO.0722.00383;ESCO.0722.00383.0131;ESCO.0722.00383.0131b_04540;1;1164;1163
ESCO.0722.00383;ESCO.0722.00383.0072;ESCO.0722.00383.0072i_04061;14264;15487;1223
ESCO.0722.00383;ESCO.0722.00383.0178;ESCO.0722.00383.0178i_04637;263;442;179
ESCO.0722.00383;ESCO.0722.00383.0233;ESCO.0722.00383.0233b_04701;3;308;305
ESCO.0722.00383;ESCO.0722.00383.0310;ESCO.0722.00383.0310b_04765;3;98;95
ESCO.0722.00383;ESCO.0722.00383.0365;ESCO.0722.00383.0365b_04797;2;82;80
ESCO.0722.00142;ESCO.0722.00142.0023;ESCO.0722.00142.0023i_03596;11006;11155;149
ESCO.0722.00142;ESCO.0722.00142.0028;ESCO.0722.00142.0028i_03963;3386;3853;467
ESCO.0722.00142;ESCO.0722.00142.0063;ESCO.0722.00142.0063b_04571;3;248;245
ESCO.0722.00142;ESCO.0722.00142.0185;ESCO.0722.00142.0185b_04731;1;69;68
ESCO.0722.00142;ESCO.0722.00142.0002;ESCO.0722.00142.0002i_00316;328374;328592;218
ESCO.0722.00142;ESCO.0722.00142.0007;ESCO.0722.00142.0007i_01500;340430;342454;2024
ESCO.0722.00142;ESCO.0722.00142.0028;ESCO.0722.00142.0028i_03964;3901;5757;1856
ESCO.0722.00142;ESCO.0722.00142.0185;ESCO.0722.00142.0185b_04732;94;222;128
ESCO.0722.00142;ESCO.0722.00142.0002;ESCO.0722.00142.0002i_00285;296346;297758;1412
ESCO.0722.00142;ESCO.0722.00142.0007;ESCO.0722.00142.0007i_01501;342439;343770;1331
ESCO.0722.00142;ESCO.0722.00142.0028;ESCO.0722.00142.0028i_03997;41826;42071;245
ESCO.0722.00142;ESCO.0722.00142.0002;ESCO.0722.00142.0002i_00368;376821;377027;206
ESCO.0722.00142;ESCO.0722.00142.0005;ESCO.0722.00142.0005i_00784;33458;34126;668
ESCO.0722.00142;ESCO.0722.00142.0023;ESCO.0722.00142.0023i_03600;14440;15741;1301
ESCO.0722.00142;ESCO.0722.00142.0024;ESCO.0722.00142.0024b_03696;95779;96018;239
ESCO.0722.00142;ESCO.0722.00142.0028;ESCO.0722.00142.0028b_04016;61245;61415;170
ESCO.0722.00142;ESCO.0722.00142.0172;ESCO.0722.00142.0172b_04720;75;251;176
ESCO.0722.00142;ESCO.0722.00142.0211;ESCO.0722.00142.0211b_04752;3;146;143
ESCO.0722.00142;ESCO.0722.00142.0002;ESCO.0722.00142.0002i_00369;377076;377606;530
ESCO.0722.00142;ESCO.0722.00142.0005;ESCO.0722.00142.0005i_00817;56827;58563;1736
ESCO.0722.00142;ESCO.0722.00142.0041;ESCO.0722.00142.0041i_04401;14699;15247;548
ESCO.0722.00142;ESCO.0722.00142.0069;ESCO.0722.00142.0069i_04593;1690;2076;386
ESCO.0722.00142;ESCO.0722.00142.0133;ESCO.0722.00142.0133b_04689;3;206;203
ESCO.0722.00142;ESCO.0722.00142.0216;ESCO.0722.00142.0216b_04754;1;135;134
ESCO.0722.00142;ESCO.0722.00142.0002;ESCO.0722.00142.0002i_00323;330261;330569;308
ESCO.0722.00142;ESCO.0722.00142.0003;ESCO.0722.00142.0003i_00451;48111;48551;440
ESCO.0722.00142;ESCO.0722.00142.0039;ESCO.0722.00142.0039i_04355;22255;22467;212
ESCO.0722.00142;ESCO.0722.00142.0118;ESCO.0722.00142.0118b_04675;220;408;188
ESCO.0722.00142;ESCO.0722.00142.0240;ESCO.0722.00142.0240b_04771;2;76;74
ESCO.0722.00142;ESCO.0722.00142.0002;ESCO.0722.00142.0002i_00324;330658;331593;935
ESCO.0722.00142;ESCO.0722.00142.0023;ESCO.0722.00142.0023i_03588;4555;4719;164
ESCO.0722.00142;ESCO.0722.00142.0039;ESCO.0722.00142.0039i_04356;22691;23176;485
ESCO.0722.00142;ESCO.0722.00142.0073;ESCO.0722.00142.0073b_04612;572;1075;503
ESCO.0722.00142;ESCO.0722.00142.0159;ESCO.0722.00142.0159b_04708;192;290;98
ESCO.0722.00142;ESCO.0722.00142.0242;ESCO.0722.00142.0242b_04772;3;71;68
ESCO.0722.00142;ESCO.0722.00142.0002;ESCO.0722.00142.0002i_00293;306847;307380;533
ESCO.0722.00142;ESCO.0722.00142.0002;ESCO.0722.00142.0002i_00325;331604;331999;395
ESCO.0722.00142;ESCO.0722.00142.0023;ESCO.0722.00142.0023i_03589;4785;5027;242
ESCO.0722.00142;ESCO.0722.00142.0036;ESCO.0722.00142.0036b_04261;2;1525;1523
ESCO.0722.00142;ESCO.0722.00142.0039;ESCO.0722.00142.0039b_04357;23195;23374;179
ESCO.0722.00142;ESCO.0722.00142.0073;ESCO.0722.00142.0073i_04613;1065;1292;227
ESCO.0722.00142;ESCO.0722.00142.0017;ESCO.0722.00142.0017b_02785;3;80;77
ESCO.0722.00142;ESCO.0722.00142.0048;ESCO.0722.00142.0048i_04481;2939;3181;242
ESCO.0722.00142;ESCO.0722.00142.0058;ESCO.0722.00142.0058b_04545;2;145;143
ESCO.0722.00142;ESCO.0722.00142.0116;ESCO.0722.00142.0116b_04673;1;450;449
ESCO.0722.00142;ESCO.0722.00142.0155;ESCO.0722.00142.0155b_04705;103;303;200
ESCO.0722.00142;ESCO.0722.00142.0194;ESCO.0722.00142.0194b_04737;3;131;128
ESCO.0722.00142;ESCO.0722.00142.0237;ESCO.0722.00142.0237b_04769;2;88;86
ESCO.0722.00142;ESCO.0722.00142.0002;ESCO.0722.00142.0002i_00290;302981;303346;365
ESCO.0722.00142;ESCO.0722.00142.0002;ESCO.0722.00142.0002i_00322;329886;330164;278
ESCO.0722.00142;ESCO.0722.00142.0048;ESCO.0722.00142.0048i_04482;3278;3697;419
ESCO.0722.00142;ESCO.0722.00142.0194;ESCO.0722.00142.0194b_04738;123;206;83
ESCO.0722.00142;ESCO.0722.00142.0166;ESCO.0722.00142.0166b_04715;2;259;257
ESCO.0722.00142;ESCO.0722.00142.0179;ESCO.0722.00142.0179b_04726;1;228;227
ESCO.0722.00142;ESCO.0722.00142.0002;ESCO.0722.00142.0002i_00311;321545;323770;2225
ESCO.0722.00142;ESCO.0722.00142.0010;ESCO.0722.00142.0010i_01847;22248;23084;836
ESCO.0722.00142;ESCO.0722.00142.0108;ESCO.0722.00142.0108b_04663;1;126;125
ESCO.0722.00142;ESCO.0722.00142.0180;ESCO.0722.00142.0180b_04727;2;73;71
ESCO.0722.00142;ESCO.0722.00142.0222;ESCO.0722.00142.0222b_04759;3;113;110
ESCO.0722.00142;ESCO.0722.00142.0016;ESCO.0722.00142.0016i_02675;117753;118124;371
ESCO.0722.00142;ESCO.0722.00142.0061;ESCO.0722.00142.0061i_04563;1648;2676;1028
ESCO.0722.00142;ESCO.0722.00142.0176;ESCO.0722.00142.0176b_04723;40;240;200
ESCO.0722.00142;ESCO.0722.00142.0061;ESCO.0722.00142.0061i_04564;2661;3197;536
ESCO.0722.00142;ESCO.0722.00142.0105;ESCO.0722.00142.0105b_04660;3;578;575
ESCO.0722.00142;ESCO.0722.00142.0177;ESCO.0722.00142.0177b_04724;2;166;164
ESCO.0722.00142;ESCO.0722.00142.0218;ESCO.0722.00142.0218b_04756;3;119;116
ESCO.0722.00142;ESCO.0722.00142.0002;ESCO.0722.00142.0002i_00286;297761;299794;2033
ESCO.0722.00142;ESCO.0722.00142.0005;ESCO.0722.00142.0005i_00798;42492;44828;2336
ESCO.0722.00142;ESCO.0722.00142.0007;ESCO.0722.00142.0007b_01502;343989;344726;737
ESCO.0722.00142;ESCO.0722.00142.0048;ESCO.0722.00142.0048i_04479;1653;2441;788
ESCO.0722.00142;ESCO.0722.00142.0114;ESCO.0722.00142.0114b_04671;386;451;65
ESCO.0722.00142;ESCO.0722.00142.0005;ESCO.0722.00142.0005i_00800;45906;46613;707
ESCO.0722.00142;ESCO.0722.00142.0154;ESCO.0722.00142.0154b_04704;189;305;116
ESCO.0722.00142;ESCO.0722.00142.0002;ESCO.0722.00142.0002i_00045;62114;62485;371
ESCO.0722.00142;ESCO.0722.00142.0128;ESCO.0722.00142.0128b_04685;2;376;374
ESCO.0722.00142;ESCO.0722.00142.0002;ESCO.0722.00142.0002i_00046;62558;62764;206
ESCO.0722.00142;ESCO.0722.00142.0028;ESCO.0722.00142.0028i_04015;59586;60857;1271
ESCO.0722.00142;ESCO.0722.00142.0032;ESCO.0722.00142.0032b_04143;2;130;128
ESCO.0722.00142;ESCO.0722.00142.0101;ESCO.0722.00142.0101b_04655;1;294;293
ESCO.0722.00142;ESCO.0722.00142.0002;ESCO.0722.00142.0002i_00312;323794;324915;1121
ESCO.0722.00142;ESCO.0722.00142.0010;ESCO.0722.00142.0010i_01848;23081;24727;1646
ESCO.0722.00142;ESCO.0722.00142.0010;ESCO.0722.00142.0010i_02008;177669;178787;1118
ESCO.0722.00142;ESCO.0722.00142.0181;ESCO.0722.00142.0181b_04728;3;227;224
ESCO.0722.00142;ESCO.0722.00142.0002;ESCO.0722.00142.0002i_00313;325016;325147;131
ESCO.0722.00142;ESCO.0722.00142.0005;ESCO.0722.00142.0005i_00793;37982;38284;302
ESCO.0722.00142;ESCO.0722.00142.0023;ESCO.0722.00142.0023i_03609;29749;29898;149
ESCO.0722.00142;ESCO.0722.00142.0071;ESCO.0722.00142.0071b_04601;1;111;110
ESCO.0722.00142;ESCO.0722.00142.0183;ESCO.0722.00142.0183b_04729;1;225;224
ESCO.0722.00142;ESCO.0722.00142.0227;ESCO.0722.00142.0227b_04761;2;109;107
ESCO.0722.00142;ESCO.0722.00142.0002;ESCO.0722.00142.0002i_00294;307383;309842;2459
ESCO.0722.00142;ESCO.0722.00142.0197;ESCO.0722.00142.0197b_04742;3;185;182
ESCO.0722.00142;ESCO.0722.00142.0004;ESCO.0722.00142.0004i_00711;274588;274995;407
ESCO.0722.00142;ESCO.0722.00142.0074;ESCO.0722.00142.0074b_04615;22;738;716
ESCO.0722.00142;ESCO.0722.00142.0162;ESCO.0722.00142.0162b_04711;2;214;212
ESCO.0722.00142;ESCO.0722.00142.0004;ESCO.0722.00142.0004i_00712;275014;275598;584
ESCO.0722.00142;ESCO.0722.00142.0074;ESCO.0722.00142.0074b_04616;1298;1393;95
